you know , one of the intense p@@ lea@@ su@@ res of travel and one of the de@@ lights of eth@@ no@@ graphic research is the opportunity to live amongst those who have not for@@ gotten the old ways , who still feel their past in the wind , touch it in st@@ ones poli@@ shed by rain , taste it in the bit@@ ter leaves of plants .	对 我 来说 在 世界各地 旅行 和 从事 人类@@ 学 研究 的 生涯 中 最大 的 乐趣 之一 莫@@ 过于 体验 那些 没有 忘记 传统 的 族@@ 群 的 生活 沐@@ 浴 在 微@@ 风 中 触摸 被 雨@@ 水 冲@@ 洗 得 晶@@ 莹 光@@ 亮 的 石头 尝@@ 着 苦@@ 叶 的 味道 你 能 感受 到 他们 的 历史
just to know that j@@ ag@@ u@@ ar sha@@ man@@ s still journey beyond the mil@@ ky way , or the my@@ ths of the in@@ u@@ it el@@ ders still res@@ on@@ ate with meaning , or that in the hi@@ mal@@ a@@ ya , the budd@@ hi@@ sts still pur@@ sue the breath of the d@@ har@@ ma , is to really remember the central rev@@ el@@ ation of anthro@@ po@@ logy , and that is the idea that the world in which we live does not exist in some absolute sense , but is just one model of reality , the con@@ sequence of one particular set of adap@@ tive choices that our lin@@ ea@@ ge made , al@@ be@@ it success@@ fully , many generations ago .	在 萨@@ 满@@ 教 的 传@@ 说 中 老@@ 虎 要 跨越 银@@ 河 因@@ 纽@@ 特 老人 的 神话 仍然 引起 后@@ 人 的 共鸣 或者 在 喜@@ 马拉@@ 雅@@ 山 佛@@ 教徒 还 在 追@@ 随 法@@ 门 这 让 我们 想起 人类@@ 学 的 核心 揭示 它 的 思想 要@@ 义 是 我们 生活 的 世界 不是 存在 于 一个 绝对 的 意识 之中 而 只是 一个 现实 模型 只是 一种 适@@ 应@@ 性 选择 的 结果 我们 的 祖先 在 很多 世@@ 代 以前 就 成功 地 做出 了 这种 选择
and of course , we all share the same adap@@ tive im@@ per@@ a@@ tives .	当然 我们 所有 都 遵@@ 守 同 一种 适@@ 应@@ 性 规则
we &apos;re all born . we all bring our children into the world .	我们 都 出 生@@ 于 母@@ 腹 并且 在 这个 世上 生@@ 儿@@ 育@@ 女
we go through initi@@ ation r@@ ites .	我们 要 经历 成年 礼 的 洗@@ 礼
we have to deal with the in@@ ex@@ or@@ able separ@@ ation of death , so it shouldn &apos;t surprise us that we all sing , we all dance , we all have art .	必须 面对 残@@ 酷 的 生@@ 离@@ 死@@ 别 因此 我们 要 歌@@ 唱 和 舞蹈 以 排@@ 遣 生活 中 的 苦@@ 楚 我们 创造 了 艺术
but what &apos;s interesting is the unique ca@@ dence of the song , the rhyth@@ m of the dance in every culture .	但是 你 会 发现 每@@ 种 文化 的 歌曲 韵@@ 律 和 舞蹈 节奏 有着 独@@ 一无@@ 二 的 特@@ 色
and whether it is the pen@@ an in the forests of bor@@ ne@@ o , or the vo@@ o@@ do@@ o ac@@ oly@@ tes in haiti , or the war@@ ri@@ ors in the k@@ ai@@ su@@ t desert of northern kenya , the cur@@ ander@@ o in the mountains of the and@@ es , or a car@@ a@@ van@@ ser@@ ai in the middle of the sahar@@ a -- this is inci@@ d@@ entally the fellow that i travel@@ ed into the desert with a month ago -- or indeed a y@@ ak her@@ der in the slo@@ pes of q@@ om@@ ol@@ ang@@ ma , ever@@ est , the go@@ d@@ de@@ ss mother of the world .	无论是 生活 在 婆@@ 罗 丛@@ 林 的 伯@@ 南@@ 人 还是 海地 的 巫@@ 毒 教@@ 侍 僧 抑@@ 或 是 北 肯尼亚 凯@@ 苏@@ 特 沙漠 的 武@@ 士 安@@ 迪@@ 斯 山@@ 区 的 巫@@ 医 或 撒哈@@ 拉@@ 沙漠 中@@ 部 的 围 帐 客@@ 栈 一个月 我 曾经 与 这个 人 一起 结@@ 伴 前往 沙漠 他 是 一位 牦@@ 牛 牧@@ 养 人 生活 在 世界 之@@ 巅 珠@@ 穆@@ 朗@@ 玛@@ 峰 的 山@@ 坡 上
all of these peop@@ les teach us that there are other ways of being , other ways of thinking , other ways of ori@@ enting yourself in the earth .	所有 这些 族@@ 群 向 我们 展现 了 不同 的 生存 方式 和 不同 的 思维 方式 以及 不同 的 人@@ 生@@ 观
and this is an idea , if you think about it , can only fill you with hope .	如果 你 认@@ 真@@ 思考 你 发@@ 会@@ 现 这种 不同 的 思维 会 让 你 看到 希望
now , together the my@@ ri@@ ad cultures of the world make up a web of spiritual life and cultural life that en@@ velo@@ ps the planet , and is as important to the well-being of the planet as indeed is the biological web of life that you know as a bio@@ sphere .	这个 世界 五@@ 彩@@ 缤@@ 纷 的 文化 犹@@ 如 一张 由 精神 生活 和 文化 生活 交@@ 织 而@@ 成 的 网 覆盖 整个 地球 它 对于 地球 的 芸@@ 芸@@ 众@@ 生 有着 十分 重要 的 意义 如同 我们 称为 生物@@ 圈 的 生态 之@@ 网 一样 重要
and you might think of this cultural web of life as being an eth@@ no@@ sphere , and you might define the eth@@ no@@ sphere as being the sum total of all thoughts and dreams , my@@ ths , ideas , inspi@@ rations , intui@@ tions brought into being by the human imagination since the da@@ wn of consciousness .	你 可以 把 这种 生命 的 文化 之@@ 网 看作 是 一个 种族 圈 这个 种族 圈 可以 被 定义 为 一个 人类 自从 有 自我@@ 意识 以来 通过 想@@ 像@@ 力 创造 的 所有 思想 和 梦想 、 神话 、 直觉 的 全部 之 和
the eth@@ no@@ sphere is humanity &apos;s great legacy .	这个 种族 圈 是 人类 的 伟大 遗@@ 产
it &apos;s the symbol of all that we are and all that we can be as an astoni@@ sh@@ ingly in@@ qui@@ si@@ tive species .	它 是 我们 的 身份 标志 也 是 我们 作为 具有 很@@ 强 的 探@@ 究 能力 的 物种 的 标志
and just as the bio@@ sphere has been sever@@ ely ero@@ ded , so too is the eth@@ no@@ sphere -- and , if anything , at a far greater rate .	如同 生物@@ 圈 受到 严重 的 侵@@ 蚀 一样 种族 圈 也 面临 着 同样 的 厄@@ 运 而且 它 的 毁灭 速度 更 快
no bio@@ logists , for example , would d@@ are suggest that 50 percent of all species or more have been or are on the br@@ ink of extin@@ ction because it simply is not true , and yet that -- the most apo@@ cal@@ y@@ p@@ tic scen@@ ari@@ o in the real@@ m of biological diversity -- scar@@ ce@@ ly appro@@ aches what we know to be the most optimistic scen@@ ari@@ o in the real@@ m of cultural diversity .	没有 任何 一位 生物学家 敢 断@@ 言 50% 或 更 多 的 物种 已经 灭绝 或者 正 处在 灭绝 的 边缘 因为 真相 并@@ 非@@ 如此 生物 多样性 的 最 悲@@ 观 的 状况 也 要 远@@ 胜 于 文化 多样性 的 最 乐观 的 状况
and the great indi@@ ca@@ tor of that , of course , is language loss .	这 其中 的 一个 最 重要 的 标志 就是 语言 的
when each of you in this room were born , there were 6@@ ,000 languages spo@@ ken on the planet .	在 我们 生活 的 这个 星球 上 原本 有 6 : 00 种 语言
now , a language is not just a body of voca@@ bu@@ lar@@ y or a set of gra@@ m@@ ma@@ tical rules .	语言 不仅仅 是 发@@ 音 和 语@@ 法 规则
a language is a fla@@ sh of the human spirit .	语言 是 人类 精神 的 闪@@ 光
it &apos;s a vehicle through which the soul of each particular culture comes into the material world .	它 是 各个 独特 文化 的 精神@@ 实@@ 质 在 这个 物质 世界 上 的 承 载@@ 体
every language is an ol@@ d-@@ growth forest of the mind , a water@@ shed , a thought , an ecosystem of spiritual possibilities .	每 一种 语言 都 是 一种 思想 一种 意识 和 一种 精神 生态系统 的 长期 沉@@ 淀 和 积累
and of those 6@@ ,000 languages , as we sit here today in mon@@ ter@@ ey , fully half are no longer being wh@@ is@@ per@@ ed into the ears of children .	我们 知道 地球 上 有 6 : 00 种 语言 这 和 我们 在座 的 观众 数量 一样 多 在 这些 语言 中 有 一半 已经 不再 向 孩子 们 传@@ 授
they &apos;re no longer being taught to babies , which means , effectively , unless something changes , they &apos;re already dead .	这些 语言 已经 没有 传@@ 人 也就是说 除非 采取@@ 有效 的 措施 它们 将会 彻底 消失
what could be more lon@@ ely than to be en@@ velo@@ ped in silence , to be the last of your people to speak your language , to have no way to pass on the wisdom of the ancestors or anticip@@ ate the promise of the children ?	想象 一下 当 你 有@@ 口@@ 难@@ 言 或者 ， 你 是 最后 一个 会 说 本@@ 族@@ 语 言 的 人 没有 办法 传@@ 承 祖先 的 智慧 也 无@@ 许 预@@ 言 孩子 们 的 未来 这会 是 多么 的 孤@@ 独 和 可怕
and yet , that dre@@ ad@@ ful f@@ ate is indeed the p@@ light of somebody somewhere on earth roughly every two weeks , because every two weeks , some el@@ der dies and car@@ ries with him into the gra@@ ve the last syl@@ lab@@ les of an ancient ton@@ gue .	另外 一个 可怕 的 事实 是 在 地球 上 大约 每 两个 星期 就 会 有 一位 年@@ 长@@ 者 仙@@ 逝 与 之 伴随 的 是 一种 古老 语言 的 消失
and i know there &apos;s some of you who say , &quot; well , wouldn &apos;t it be better , wouldn &apos;t the world be a better place if we all just spoke one language ? &quot; and i say , &quot; great , let &apos;s make that language yor@@ u@@ ba . let &apos;s make it can@@ ton@@ ese .	我 知道 你们 有人 会 说 那样 岂 不是 更好 吗 如果 世界 上 只有 一种 语言 那 不是 更好 吗 那么 我 要说 假设 这种 唯一 的 语言 是 约 鲁@@ 巴@@ 语 或者 是 粤@@ 语
let &apos;s make it ko@@ g@@ i . &quot;	或者 是 科@@ 基@@ 语
and you &apos;ll suddenly discover what it would be like to be un@@ able to speak your own language .	你 就 会 发现 你 不会 说 自己 的 母@@ 语 了
and so , what i &apos;d like to do with you today is sort of take you on a journey through the eth@@ no@@ sphere , a brief journey through the eth@@ no@@ sphere , to try to begin to give you a sense of what in fact is being lost .	因此 今天 我要 做 的 事情 就是 带领 你们 去 探索 这个 种族 圈 让 你们 对 种族 圈@@ 有 大@@ 致 的 了解 并且 让 你们 切@@ 身@@ 感受 到 正在 灭@@ 亡 的 文明
now , there are many of us who sort of forget that when i say &quot; different ways of being , &quot; i really do mean different ways of being .	可能 有 很多 人 已经 忘 了 前面 我 说 过 的 “ 不同 的 生存 方式 ” 前面 我 说 过 的 “ 不同 的 生存 方式 ”
take , for example , this child of a bar@@ as@@ ana in the nor@@ th@@ west amaz@@ on , the people of the an@@ ac@@ on@@ da who believe that my@@ tho@@ logically they came up the milk river from the east in the bel@@ ly of sac@@ red sna@@ kes .	举个 例子 这个 小孩 生活 在 亚@@ 玛@@ 逊 西@@ 北部 的 巴@@ 拉 撒@@ 拉 地区 他们 被 称为 森 蚺 之@@ 族 因为 他们 相信 一个 传@@ 说 即 他们 来自 米@@ 尔@@ 克 河@@ 东@@ 岸 诞生 于 神圣 的 蛇 腹
now , this is a people who cogni@@ tively do not distin@@ gu@@ ish the color blue from the color green because the can@@ op@@ y of the hea@@ ven@@ s is equ@@ ated to the can@@ op@@ y of the forest upon which the people depend .	这个 族@@ 群 的 人 不能 区分 蓝色 和 绿色 因为 丛@@ 林 是 他们 的 栖@@ 身@@ 之@@ 地 所以 在 他们 看来 天@@ 穹 与 森林 的 树@@ 冠 并 没有 区别
they have a curious language and marriage rule which is called &quot; lin@@ gu@@ istic ex@@ o@@ ga@@ my : &quot; you must mar@@ ry someone who spea@@ ks a different language .	他们 说 着 一种 奇怪 的 语言 并且 遵@@ 守 一种 独特 的 通@@ 婚 规则 这 称为 语@@ 言@@ 学 异@@ 族@@ 通@@ 婚 一位 族@@ 人 必须 与 操 一种 不同 语言 的 人 结婚
and this is all ro@@ ot@@ ed in the my@@ tho@@ logical past , yet the curious thing is in these long houses , where there are six or seven languages spo@@ ken because of inter@@ marriage , you never hear anyone practic@@ ing a language .	这 都 是 根据 神@@ 话@@ 传@@ 说 的 历史 传@@ 承 下来 的 你 可以 看到 一个 奇怪 的 现象 由于 异@@ 族 同@@ 婚 的 缘@@ 故 一个 大@@ 家族 往往 有 六@@ 七@@ 种 语言 你 从 不会 看到 有人 操@@ 练 一种 语言
they simply listen and then begin to speak .	他们 只要 会 听 就 会 说 一种 语言 了
or , one of the most fascinating tri@@ bes i ever lived with , the wa@@ oran@@ i of nor@@ the@@ a@@ stern ecu@@ ad@@ or , an astonishing people first cont@@ acted peace@@ fully in 195@@ 8 .	在 我 曾经 接触 过 的 众多 种族 厄@@ 瓜@@ 多@@ 尔 东@@ 北部 的 华 拉@@ 尼 族@@ 人 是 最 奇妙 的 种族 之一 早 在 195@@ 8 年 ， 我 曾经 与 他们 有过 和@@ 平@@ 友@@ 好 的 接触
in 195@@ 7 , five mis@@ sion@@ aries attemp@@ ted contact and made a critical mistake .	195@@ 7 年 五@@ 名 传@@ 教@@ 士 试图 接近 他们 但是 这些 人@@ 犯 了 一个 致命 的 错误
they dropped from the air 8 x 10 glo@@ ss@@ y photographs of themselves in what we would say to be friendly ge@@ stu@@ res , for@@ getting that these people of the rain@@ forest had never seen anything two-@@ dimensional in their lives .	他们 从 空中 丢@@ 下 八@@ 到 十@@ 张 他们 本@@ 人 的 照片 在 我们 看来 这是 友@@ 好 的 表示 但是 他们 却 没有 想到 这些 生活 在 雨@@ 林@@ 中 的 人 从来 没有 见过 二@@ 维 的 照片
they picked up these photographs from the forest floor , tried to look behind the face to find the form or the figure , found nothing , and conclu@@ ded that these were calling cards from the devi@@ l , so they spe@@ ared the five mis@@ sion@@ aries to death .	他们 从 林@@ 地 上 捡@@ 起 这些 照片 然后 把 照片 翻@@ 过来 试图 找到 这些 人 的 身@@ 影 但是 他们 发现 什么 也 没有 于是 他们 认为 这是 恶@@ 魔 发出 的 召@@ 唤 卡@@ 片 于是 他们 用 长@@ 矛 戮 死 了 这 五@@ 名 传@@ 教@@ 士
but the wa@@ oran@@ i didn &apos;t just spe@@ ar out@@ si@@ ders .	更 恐怖 的 是 华 拉@@ 尼 不仅 戮 死 外@@ 来 人士
they spe@@ ared each other .	他们 还 自@@ 相@@ 残@@ 杀
5@@ 4 percent of their mortality was due to them spe@@ aring each other .	5@@ 4@@ % 的 死亡 人口 是 被 他们 自己 的 族@@ 人 戮 死 的
we trac@@ ed gene@@ alo@@ gies back eight generations , and we found two inst@@ ances of natural death and when we pres@@ su@@ red the people a little bit about it , they ad@@ mitted that one of the fel@@ lo@@ ws had gotten so old that he died getting old , so we spe@@ ared him anyway .	我们 对 一个 八@@ 代 宗@@ 谱 进行 调查 发现 只有 两@@ 例 自然 死亡 我们 刨@@ 根@@ 问@@ 底 他们 终于 道 出 真相 同@@ 族 人 年@@ 迈 不@@ 堪 行 就 将 木 的 时候 他们 就@@ 会@@ 戮 死 他 为 他 送@@ 终
but at the same time they had a per@@ spi@@ ca@@ ci@@ ous knowledge of the forest that was astonishing .	另一方面 他们 对 丛@@ 林 有着 令人 惊@@ 诧 的 洞@@ 察@@ 力
their hun@@ ters could smell animal ur@@ ine at 40 pac@@ es and tell you what species left it behind .	他们 的 猎@@ 手 能够 闻@@ 到 40 步 开@@ 外 的 动物 尿@@ 液 味道 而且 知道 那 是 什么 动物 的 尿@@ 液
in the early &apos; 80s , i had a really astonishing as@@ sign@@ ment when i was asked by my professor at harvard if i was interested in going down to haiti , in@@ fil@@ tr@@ ating the secret societies which were the foundation of du@@ v@@ ali@@ er &apos;s strength and ton@@ ton mac@@ out@@ es , and secur@@ ing the po@@ ison used to make z@@ om@@ bi@@ es .	在 80 年代 早期 我 曾经 承担 了 一项 奇妙 的 任务 我 在 哈@@ 佛@@ 大学 的 教授 问 我 是否 有 兴趣 去 海地 去 潜@@ 入 一个 秘密 社@@ 团 那 是 海地 总统 杜@@ 华@@ 利 和 他 的 政@@ 权 支@@ 持@@ 者 的 基地 教授 让 我 去 那里 获取 一种 用于 制造 僵@@ 尸 的 毒@@ 药
in order to make sense out of sen@@ sation , of course , i had to understand something about this remarkable faith of vo@@ dou@@ n . and vo@@ o@@ do@@ o is not a black magic cul@@ t .	为了 理解 其中 的 奥@@ 秘 我 必须 弄 明白 这种 神奇 的 宗教@@ 信仰 巫@@ 毒 教@@ 是 怎么 一 回事 巫@@ 毒@@ 教 不是 一种 黑暗 的 魔@@ 纪 教@@ 派
on the con@@ tr@@ ary , it &apos;s a complex meta@@ physical world@@ view .	相反 这是 一种 复杂 的 形@@ 而@@ 上学 的 世界@@ 观
it &apos;s interesting .	这 很 有意思
if i asked you to name the great religions of the world , what would you say ?	如果 我要 你 列@@ 举 出 世界 上 一些 重要 的 宗教 你 会 举@@ 出 哪些 例子
christi@@ an@@ ity , islam , budd@@ hi@@ sm , ju@@ da@@ ism , whatever .	基督@@ 教 伊斯兰教 佛@@ 教 还有 其他 一些 宗教
there &apos;s always one continent left out , the assu@@ mption being that sub-@@ sahar@@ an africa had no religious beli@@ efs . well , of course , they did and vo@@ o@@ do@@ o is simply the di@@ sti@@ l@@ lation of these very profound religious ideas that came over during the tra@@ gic di@@ as@@ por@@ a of the sla@@ very era .	有 一个 大陆 始终 被 遗@@ 忘 很多 人 认为 撒哈@@ 拉 以@@ 南 的 非洲@@ 地区 没有 宗教@@ 信仰 这 是 不 正确 的 在 大 饥@@ 荒 时代 这些 地区 的 人 流@@ 浪 到 世界各地 把 他们 的 宗教@@ 信仰 也 带到 那里 而 巫@@ 毒@@ 教 融@@ 汇 这些 宗教 的 精@@ 华
but , what makes vo@@ o@@ do@@ o so interesting is that it &apos;s this living relationship between the living and the dead .	巫@@ 毒 的 独特 之 处 在于 它 是 生@@ 者 与 死@@ 者 之间 的 一种 联系
so , the living give birth to the spir@@ its .	生 者 孕@@ 育 了 灵魂
the spir@@ its can be inv@@ o@@ ked from bene@@ ath the great water , respon@@ ding to the rhyth@@ m of the dance to mom@@ ent@@ arily dis@@ place the soul of the living , so that for that brief sh@@ ining moment , the ac@@ oly@@ te becomes the god .	应@@ 着 舞蹈 的 节奏 翩@@ 翩@@ 起@@ 舞 可以 唤@@ 醒 大@@ 水 之下 的 灵魂 暂@@ 时 地 代替 生@@ 者 的 灵魂 在 那个 短@@ 暂 的 闪@@ 光 时刻 侍@@ 僧 成为 神
that &apos;s why the vo@@ o@@ do@@ o@@ ists like to say that &quot; you white people go to church and speak about god .	因此 巫@@ 毒 教徒 喜欢 说 你们 去 教堂 做@@ 礼@@ 拜 言 必@@ 称 上帝
we dance in the temp@@ le and become god . &quot;	我们 在 圣@@ 殿 起@@ 舞 成为 神
and because you are pos@@ se@@ ssed , you are taken by the spirit -- how can you be har@@ med ?	你 已经 被 神@@ 灵 附@@ 体 怎么 还会 受到 伤害 呢
so you see these astonishing demon@@ stra@@ tions : vo@@ o@@ do@@ o ac@@ oly@@ tes in a state of tr@@ ance hand@@ ling burning e@@ mbers with imp@@ unity , a rather astonishing demon@@ stration of the ability of the mind to affect the body that be@@ ars it when catal@@ y@@ zed in the state of extreme exc@@ itation .	于是 你 会 看 一些 令人 惊奇 的 现象 巫@@ 毒 教@@ 侍 僧 进入 一种 神@@ 志 恍@@ 惚 的 状态 手@@ 持 燃烧 的 枝@@ 条 但是 毫@@ 发@@ 无@@ 损 当 他们 进入 一种 极端 亢@@ 奋 的 状态 时候 你 还 会 看到 更加 令人@@ 吃惊 的 现象 让 你 感受 意@@ 志@@ 力 的 强大
now , of all the peop@@ les that i &apos;ve ever been with , the most extraordinary are the ko@@ g@@ i of the si@@ er@@ ra ne@@ v@@ ada de s@@ ant@@ a mar@@ ta in northern col@@ om@@ bia .	在 我 接触 过 的 所有 族@@ 群 中 生活 在 哥伦@@ 比亚 北部 的 圣@@ 玛@@ 尔@@ 塔 山@@ 区 的 科@@ 基@@ 人 是 最 不同@@ 寻常 的
de@@ scen@@ dan@@ ts of the ancient ta@@ ir@@ on@@ a civilization which once car@@ pe@@ ted the car@@ ib@@ be@@ an co@@ ast@@ al pla@@ in of col@@ om@@ bia , in the wake of the con@@ quest , these people re@@ treated into an is@@ ol@@ ated vol@@ can@@ ic ma@@ ssi@@ f that so@@ ars above the car@@ ib@@ be@@ an co@@ ast@@ al pla@@ in .	这个 种族 是 古@@ 代 暴@@ 政 文明 的 后@@ 裔 他们 曾经 一@@ 度 征@@ 服 和 占@@ 领 了 哥伦@@ 比亚 的 加@@ 勒@@ 比@@ 海 岸 平@@ 原 地区 此@@ 后 他们 退@@ 回 到 加@@ 勒@@ 比@@ 海 岸 平@@ 原 的 一个 与@@ 世@@ 隔@@ 绝 的 山@@ 区
in a bloo@@ d@@ sta@@ ined continent , these people alone were never con@@ qu@@ ered by the span@@ ish .	在 这个 血@@ 腥 肆@@ 虐 的 大陆 这个 种族 从来 没有 被 西班@@ 牙@@ 人 征@@ 服 过
to this day , they remain r@@ ul@@ ed by a r@@ itual pri@@ es@@ tho@@ od but the training for the pri@@ es@@ tho@@ od is rather extraordinary .	至@@ 到 今天 他们 沿@@ 续 着 僧@@ 侣 会 统治 制度 但是 他们 的 僧@@ 侣 训@@ 诫 非常 的 独特
the young ac@@ oly@@ tes are taken away from their families at the age of three and four , sequ@@ est@@ ered in a sha@@ dow@@ y world of dar@@ kness in stone hu@@ ts at the base of gl@@ aci@@ ers for 18 years : two n@@ ine@@ -@@ year peri@@ ods deli@@ ber@@ ately cho@@ sen to mi@@ mic the nine months of ge@@ station they spend in their natural mother &apos;s wom@@ b ; now they are metaph@@ or@@ ically in the wom@@ b of the great mother .	还 只有 三@@ 四@@ 岁 的 时候 年@@ 幼 的 侍@@ 僧 就 被 带 离 他们 的 家庭 隐@@ 居 在 黑@@ 暗@@ 世界 的 冰川 上@@ 用 石头 彻@@ 成 的 小 屋@@ 里 待 到 十@@ 八@@ 岁 十@@ 八@@ 年 是 两个 九@@ 年 之 和 它 象征 在 母@@ 腹 的 九@@ 月 怀@@ 胎 在@@ 此@@ 期间
and for this entire time , they are in@@ cul@@ tur@@ ated into the values of their society , values that maintain the pro@@ position that their pra@@ yers and their pra@@ yers alone maintain the cos@@ mic -- or we might say the eco@@ logical -- balance .	他们 如同 重新 回到 母@@ 腹 被 灌@@ 输 族@@ 群 的 价值观 这些 价值观 是 维@@ 系 着 信@@ 徒 与 宇宙 之间 的 关系 我们 可 称之为 生态@@ 平衡
and at the end of this amazing initi@@ ation , one day they &apos;re suddenly taken out and for the first time in their lives , at the age of 18 , they see a sun@@ rise . and in that cry@@ st@@ al moment of awareness of first light as the sun begins to ba@@ the the slo@@ pes of the stun@@ n@@ ingly beautiful landscape , suddenly everything they have learned in the abstract is af@@ fir@@ med in stun@@ ning gl@@ ory . and the pri@@ est steps back and says , &quot; you see ? it &apos;s really as i &apos;ve told you .	直到 他们 十@@ 八@@ 岁 的 时候 这种 神奇 的 洗@@ 礼 结束 他们 生@@ 平 第一次 走出 小@@ 屋 看到 阳光 在 阳光 的 照@@ 耀 下 大@@ 地 呈@@ 现@@ 出 令人 震@@ 撼 的 壮@@ 观 美@@ 景 那一刻 意识 突然 苏@@ 醒 他们 以前 学到 的 所有 抽象 知识 都 是 在 令人@@ 惊叹 的 荣@@ 耀 中 得到 印@@ 证 这时 祭@@ 司 走过 来说 看到 了 吧 我 以前 教 你 的 都 是 真的
it is that beautiful . it is y@@ ours to protect . &quot;	这里 是 多么 的 美丽 你 要 保护 它
they call themselves the &quot; el@@ der brothers &quot; and they say we , who are the younger brothers , are the ones responsible for destro@@ ying the world .	他们 称 自己 为 兄@@ 长 称 我们 为 弟@@ 兄 说 我们 是 破坏 世界 的 人
now , this level of intu@@ ition becomes very important .	这种 直觉 的 领@@ 会 能力 非常 重要
whenever we think of indi@@ gen@@ ous people and landscape , we either inv@@ o@@ ke rou@@ s@@ se@@ a@@ u and the old can@@ ard of the &quot; no@@ ble sav@@ age , &quot; which is an idea rac@@ ist in its simplicity , or alter@@ na@@ tively , we inv@@ o@@ ke tho@@ rea@@ u and say these people are closer to the earth than we are .	说 到 土@@ 族 居民 和 原始 的 风@@ 土@@ 人@@ 情 我们 会 想到 罗@@ 素 关于 那个 高@@ 贵 的 野@@ 人 的 古老 传@@ 说 那 一个 理想 的 种族@@ 主义者 我们 会 想到 梭@@ 罗 这些 人@@ 比 我们 更 亲@@ 近 大@@ 地
well , indi@@ gen@@ ous people are neither s@@ enti@@ mental nor wea@@ ken@@ ed by no@@ st@@ al@@ gi@@ a .	土@@ 著@@ 人 并 不会 多@@ 愁@@ 善@@ 感 也 不会 承受 思@@ 乡 之@@ 苦
there &apos;s not a lot of room for either in the mal@@ ari@@ al sw@@ am@@ ps of the as@@ m@@ at or in the chil@@ ling win@@ ds of ti@@ bet , but they have , ne@@ ver@@ theless , through time and r@@ itual , for@@ ged a traditional my@@ sti@@ que of the earth that is based not on the idea of being self-@@ consci@@ ously close to it , but on a far sub@@ t@@ ler intu@@ ition : the idea that the earth itself can only exist because it is brea@@ the@@ d into being by human consciousness .	在 疟疾 盛@@ 行 的 阿@@ 斯@@ 玛 特 湿@@ 地 在 寒@@ 风@@ 刺@@ 骨 的 西@@ 藏 并 没有 多少 平@@ 整 的 土地 但是 他们 依靠 众人 的 力量 经@@ 年@@ 累@@ 月 在 世上 创造 了 流@@ 传 百@@ 世 的 神@@ 迹 这 并 不是 因为 他们 自@@ 觉 地 认识 到 这 一点 而且 凭@@ 借 非常 敏感 的 直觉 他们 认为 这个 世界 本身 的 存在 是因为 人类 的 意识 吸收 了 自然 的 精@@ 华
now , what does that mean ?	那么 这是 什么 意思 呢
it means that a young kid from the and@@ es who &apos;s raised to believe that that mountain is an ap@@ u spirit that will direct his or her dest@@ in@@ y will be a prof@@ oun@@ dly different human being and have a different relationship to that resource or that place than a young kid from mon@@ tan@@ a raised to believe that a mountain is a pile of rock ready to be min@@ ed .	我们 可以 打@@ 个@@ 比@@ 方 一位 生活 在 安@@ 第@@ 斯@@ 山脉 的 小孩 大 人们 从@@ 小 就 教@@ 导 他 说 那里 的 大@@ 山 是 阿@@ 普@@ 神 的 化@@ 身 它 将 会 指@@ 引 他们 的 命运 他们 是 一类 完全 不同 的 人 他们 与 那里 的 自然@@ 环境 和 生@@ 养 之@@ 地 有着 一种 不同 的 关系 而 在 蒙@@ 大@@ 拿@@ 州 的 年轻人 看来 一座 大@@ 山 只不过 是 一堆 石头 可以 用来 开采 石@@ 矿
whether it &apos;s the abo@@ de of a spirit or a pile of ore is ir@@ relevant .	无论 那@@ 座 大@@ 山 是 神 的 住@@ 所 或者 仅仅 是 一堆 矿@@ 石 这 都 不 重要
what &apos;s interesting is the metaphor that defin@@ es the relationship between the individual and the natural world .	重要 的 是 这种 象@@ 征@@ 意义 阐述 了 人@@ 与@@ 自然 之间 的 关系
i was raised in the forests of british colum@@ bia to believe those forests existed to be cut .	我 在 英@@ 属 哥伦@@ 比亚 的 丛@@ 林 长大 受 当@@ 地@@ 人 思想 的 影响 我 认为 丛@@ 林 是 要 被 砍@@ 伐 的
that made me a different human being than my friends amongst the k@@ wa@@ gi@@ ul@@ th who believe that those forests were the abo@@ de of hu@@ x@@ wh@@ u@@ k@@ w and the cro@@ o@@ ked be@@ ak of hea@@ ven and the can@@ ni@@ bal spir@@ its that d@@ wel@@ led at the north end of the world , spir@@ its they would have to engage during their ha@@ mat@@ sa initi@@ ation .	这种 想法 让 我 与 夸 基@@ 特@@ 尔 部落 的 朋友 们 成为 两@@ 类 截@@ 然@@ 不同 的 人 因为 他们 相信 这些 树木 是 胡@@ 克 神 和 天堂 之@@ 眼 的 化@@ 身 吃 人 的 精@@ 灵 在 世界 的 最 北@@ 边 在 哈 马@@ 撒 成@@ 人@@ 礼 上 他们 会 与 这些 精@@ 灵 开@@ 战
now , if you begin to look at the idea that these cultures could create different re@@ alities , you could begin to understand some of their extraordinary disco@@ ver@@ ies . take this plant here .	如果 你 从 这个 角度 来看 你 就 会 发现 这些 文化 创造 了 不同 的 生活 方式 你 就 会 明白 他们 与众不同 的 生活 方式
it &apos;s a photograph i took in the nor@@ th@@ west amaz@@ on just last a@@ pri@@ l .	这张 照片 是 我 去年 八@@ 月份 在 亚@@ 马@@ 逊 西@@ 北@@ 地区 拍摄 的
this is ay@@ a@@ hu@@ as@@ ca , which many of you have heard about , the most powerful psycho@@ active prepar@@ ation of the sha@@ man &apos;s re@@ per@@ toi@@ re .	这是 阿@@ 亚 胡@@ 斯@@ 卡@@ 藤 俗@@ 称 死@@ 藤 你们 很多 人 都 听说 过 它 是 一种 非常 强@@ 效 的 精神 麻@@ 醉 植物 萨@@ 满@@ 教 徒 常@@ 用 它 制作 迷@@ 幻@@ 药 - 死@@ 藤@@ 水
what makes ay@@ a@@ hu@@ as@@ ca fascinating is not the she@@ er pharmac@@ o@@ logical potential of this prepar@@ ation , but the el@@ ab@@ or@@ ation of it . it &apos;s made really of two different sources : on the one hand , this woo@@ dy li@@ ana which has in it a series of be@@ ta@@ -@@ carb@@ ol@@ ines , har@@ mine , har@@ mal@@ ine , mil@@ dly hall@@ uc@@ in@@ ogen@@ ic -- to take the v@@ ine alone is rather to have sort of blue ha@@ zy smoke dri@@ ft across your consciousness -- but it &apos;s mi@@ xed with the leaves of a sh@@ ru@@ b in the coffee family called psy@@ ch@@ ot@@ ri@@ a vi@@ ri@@ d@@ is .	死@@ 藤@@ 水 的 奇妙 之 处 不 在于 它 神奇 的 药@@ 用 性 而 在于 它 的 加@@ 工 方法 实际上 它 由 两种 物质 组成 一方面 它 是 一种 藤@@ 本@@ 植物 含有 β - 咔@@ 啉 蓬 硷 和 微@@ 量 的 致@@ 幻 成@@ 份 就 拿 它 的 藤 来说 你 似乎 可以 看到 一层 蓝色 的 烟@@ 雾 它 与 一种 名为 九@@ 节 木 的 咖啡 属 灌@@ 木 的 枝@@ 叶 混@@ 杂 在 一起
this plant had in it some very powerful tr@@ y@@ p@@ ta@@ min@@ es , very close to brain ser@@ ot@@ on@@ in , di@@ meth@@ y@@ l@@ tr@@ y@@ p@@ ta@@ mine , 5@@ -@@ meth@@ oxy@@ di@@ meth@@ y@@ l@@ tr@@ y@@ p@@ ta@@ mine .	这种 植物 具有 一种 强@@ 效 的 色@@ 胺 它 的 成分 与 脑@@ 内 的 5 - 羟@@ 色@@ 胺 的 成@@ 份 非常 接近
if you &apos;ve ever seen the y@@ an@@ om@@ ami blo@@ wing that s@@ nu@@ ff up their no@@ ses , that sub@@ stance they make from a different set of species also contains meth@@ oxy@@ di@@ meth@@ y@@ l@@ tr@@ y@@ p@@ ta@@ mine .	亚@@ 诺 马@@ 米 部落 的 人 也 会 从 含有 5 - 羟@@ 色@@ 胺 的 植物 中 提取 这种 物质 并且 用 鼻子 吸@@ 食
to have that po@@ w@@ der blo@@ wn up your nose is rather like being shot out of a ri@@ f@@ le bar@@ re@@ l lin@@ ed with bar@@ o@@ que paintings and lan@@ ding on a sea of electricity .	如果 你 用 鼻 吸@@ 入 这些 粉@@ 末 你 会 看到 光@@ 怪@@ 陆@@ 离 的 幻觉 处于 一种 非常 亢@@ 奋 的 状态
it doesn &apos;t create the di@@ stor@@ tion of reality ; it creates the diss@@ olution of reality .	现实 在 你 面前 不是 扭@@ 曲 而是 荡@@ 然@@ 无@@ 存
in fact , i used to argue with my professor , richard ev@@ an sh@@ ul@@ tes -- who is a man who s@@ par@@ ked the psy@@ che@@ deli@@ c era with his discovery of the magic mush@@ rooms in mexico in the 19@@ 3@@ 0s -- i used to argue that you couldn &apos;t classi@@ fy these tr@@ y@@ p@@ ta@@ min@@ es as hall@@ uc@@ in@@ ogen@@ ic because by the time you &apos;re under the effects there &apos;s no one home anymore to experience a hall@@ uc@@ ination .	事实上 我 曾经 与 我 的 导@@ 师 richard ev@@ an sh@@ ul@@ tes 争论 过 上 世纪 30 年代 我 的 导@@ 师 曾经 在 墨西哥 发现 一种 神奇 的 蘑菇 具有 很@@ 强 的 迷@@ 幻 效果 我 曾经 和 他 争论 说 你 不能 把 这些 色@@ 胺 归@@ 入 迷@@ 幻 成@@ 份 类@@ 别 因为 当 它们 在 你 身上 发挥 效@@ 力 的 时候 你 已经 无法 体验 到 迷@@ 幻 的 感觉
but the thing about tr@@ y@@ p@@ ta@@ min@@ es is they cannot be taken or@@ ally because they &apos;re den@@ at@@ u@@ red by an en@@ z@@ y@@ me found naturally in the human gu@@ t called mon@@ o@@ am@@ ine ox@@ i@@ da@@ se .	但是 这些 色@@ 胺 物质 并 不能 口@@ 服 因为 它们 会 被 人@@ 体@@ 器官 中 的 一种 名为 单@@ 胺 氧化@@ 酶 的 酶 改变 活@@ 性
they can only be taken or@@ ally if taken in con@@ jun@@ ction with some other chemical that den@@ atures the ma@@ o .	要 口@@ 服 这些 色@@ 胺 物质 还有 必须 同时 口@@ 服 改变 单@@ 胺 氧化@@ 酶 的 活@@ 性 的 其他 化学物质
now , the fascinating things are that the be@@ ta@@ -@@ carb@@ ol@@ ines found within that li@@ ana are ma@@ o in@@ hi@@ bit@@ ors of the preci@@ se sort necessary to pot@@ enti@@ ate the tr@@ y@@ p@@ ta@@ mine . so you ask yourself a question .	有意思 的 是 这种 藤@@ 本@@ 植物 中 存在 的 β - 咔@@ 啉 正好 能够 抑制 单@@ 胺 氧化@@ 酶 而 发挥 色@@ 胺 的 效@@ 力 因此 你 不@@ 由@@ 得 要 问 自己
how , in a fl@@ ora of 8@@ 0,000 species of vas@@ cular plants , do these people find these two mor@@ pho@@ logically un@@ related plants that when combined in this way , created a kind of bio@@ chemical version of the whole being greater than the sum of the parts ?	在 这片 丛@@ 林@@ 中 有 80 : 00 种 植物 那里 的 人们 是 如何 发现 这 两种 在 形态 上 毫无 关联 的 植物 组合 在 一起 会 发挥 这种 神奇 的 效@@ 力 这 如同 一种 生@@ 化 实验 多种 成分 产生 的 化学 效应 大@@ 于 各 成分 的 效@@ 力 之 和
well , we use that great eu@@ ph@@ e@@ mism , &quot; trial and error , &quot; which is exposed to be meaning@@ less .	我们 普通@@ 人 会 做 各种各样 的 实验 不断 地 犯@@ 错误 结果 却 一无@@ 所@@ 获
but you ask the indi@@ ans , and they say , &quot; the plants talk to us . &quot;	但是 如果 你 问 印@@ 第@@ 安@@ 人 他们 会 说 植物 会 说话
well , what does that mean ?	那 是 什么 意思 呢
this tri@@ be , the co@@ fan , has 17 vari@@ e@@ ties of ay@@ a@@ hu@@ as@@ ca , all of which they distin@@ gu@@ ish a great distance in the forest , all of which are refer@@ able to our eye as one species .	科@@ 凡 部落 的 人 发现 了 17 种@@ 死 藤 全部 是 他们 在 丛@@ 林 深处 发现 的 在 我们 看来 它们 是 不同 的 物种
and then you ask them how they estab@@ lish their ta@@ x@@ on@@ omy and they say , &quot; i thought you knew something about plants .	如果 你 问 他们 是 如何 给 这些 植物 分@@ 门@@ 别@@ 类 的 他们 说 我 想 你 对 植物 有 一些 研究
i mean , don &apos;t you know anything ? &quot; and i said , &quot; no . &quot;	你 是不是 对 植物 有 一定 的 了解 我 说 不是
well , it turns out you take each of the 17 vari@@ e@@ ties in the night of a full moon , and it sin@@ gs to you in a different key .	那 我 告诉 你 他们 说道 如果 在 月 圆@@ 之@@ 夜 这 17 种 植物 的 每 一种 植物 会 用 不同 的 密@@ 语 向 你 歌@@ 唱
now , that &apos;s not going to get you a ph@@ .@@ d. at harvard , but it &apos;s a lot more interesting than coun@@ ting st@@ am@@ ens .	这个 发现 不会 让 你 得到 哈@@ 佛@@ 大学 的 博@@ 士@@ 学位 但是 它 远 比 会@@ 计@@ 报@@ 表 更 有 乐趣
now -- -- the problem -- the problem is that even those of us sym@@ pa@@ thetic with the p@@ light of indi@@ gen@@ ous people view them as qua@@ int and color@@ ful but somehow reduc@@ ed to the mar@@ g@@ ins of history as the real world , meaning our world , moves on .	现在 （ 鼓掌 ） 我们 面临 这样 一个 问题 虽然 我们 中 的 一些 人 同情 土@@ 著@@ 人 的 遭遇 认为 他们 离@@ 群@@ 索@@ 居 生活 丰@@ 富@@ 多@@ 彩 但是 随着 我们 的 世界 向前 发展 这些 人 退@@ 居 到 历史 的 边缘 地位
well , the truth is the 20th century , 300 years from now , is not going to be rememb@@ ered for its wars or its technological innovations , but rather as the era in which we stood by and either ac@@ tively end@@ or@@ sed or pas@@ sively accep@@ ted the massive destruction of both biological and cultural diversity on the planet . now , the problem isn &apos;t change .	对于 20 世纪 以及 今@@ 后 的 300 年 后@@ 人 所 记住 的 不会 这 期间 发生 的 战争 或者 它 的 科技 创新 而@@ 会 记住 在 我们 这个 时代 积极 地 对 地球 上 的 生态 和 文化 多样性 进行 大规模 的 破坏 或者 被@@ 动 地 接受 这个 局@@ 面 现在 局@@ 面 依然 没有 改变
all cultures through all time have constantly been engaged in a dance with new possibilities of life .	所有 的 文化 一直 受到 新 的 生活 方式 的 强烈 冲@@ 击
and the problem is not technology itself .	这个 问题 并 不 在于 技术 本身
the si@@ ou@@ x indi@@ ans did not stop being si@@ ou@@ x when they gave up the bow and ar@@ row any more than an american stopped being an american when he gave up the horse and bu@@ g@@ gy .	苏@@ 族 印@@ 第@@ 安@@ 人 即使 放@@ 下 弓@@ 箭 仍然 还是 苏@@ 族 印@@ 第@@ 安@@ 人 而 美国 人 告@@ 别 骑@@ 马 和 坐 马@@ 车 的 生活 依然 还是 美国 人
it &apos;s not change or technology that threat@@ ens the integr@@ ity of the eth@@ no@@ sphere . it is power , the cru@@ de face of dom@@ ination .	威胁 种族 圈 完@@ 整@@ 性 的 不是 变革 或 技术@@ 创新 本身 而是 权力 是 野@@ 蛮 的 排 他 主义
wherever you look around the world , you discover that these are not cultures dest@@ ined to fa@@ de away ; these are dynamic living peop@@ les being driven out of existence by identi@@ fi@@ able forces that are beyond their capacity to adapt to : whether it &apos;s the e@@ gre@@ gi@@ ous de@@ fore@@ station in the hom@@ el@@ and of the pen@@ an -- a n@@ om@@ adi@@ c people from sou@@ the@@ ast asia , from s@@ ara@@ wa@@ k -- a people who lived free in the forest until a generation ago , and now have all been reduc@@ ed to ser@@ v@@ itu@@ de and pro@@ stitu@@ tion on the banks of the ri@@ vers , where you can see the river itself is so@@ iled with the si@@ lt that seems to be carrying half of bor@@ ne@@ o away to the south china sea , where the japanese fre@@ igh@@ ters hang light in the horiz@@ on ready to fill their holds with raw lo@@ gs ri@@ pped from the forest -- or , in the case of the y@@ an@@ om@@ ami , it &apos;s the disease enti@@ ties that have come in , in the wake of the discovery of gold .	观察 我们 周围 的 世界 你 就 会 发现 没有 一种 文化 是 注@@ 定 要 消@@ 亡 的 这些 原本 富有 生@@ 机 活力 的 人群 被 强@@ 暴 的 力量 驱@@ 逐 出 他们 的 生@@ 养 之@@ 地 让 他们 感到 无所@@ 适@@ 从 无论是 伯@@ 南 腹@@ 地 肆@@ 无@@ 忌@@ 惮 的 森林 砍@@ 伐 还是 东@@ 南@@ 亚 的 撒@@ 拉 瓦@@ 克 游@@ 民 部落 他们 上@@ 代 人 还 自由@@ 自@@ 在 地 生活 在 丛@@ 林@@ 中 而 现在 全部 已经 沦@@ 落 为 仆@@ 役 和 妓@@ 女 在 河 岸@@ 边 你 可以 看到 河@@ 水 泥@@ 沙 很 重 似乎 要 把 婆@@ 罗 族 的 一半 居@@ 住@@ 地 冲@@ 走 到 南@@ 中@@ 国@@ 海 在 那里 日本 的 人 货@@ 船 已经 整@@ 装@@ 待@@ 发 准备 运@@ 走 从 森林 砍@@ 伐 的 圆@@ 木 我们 再 来看 亚@@ 诺 马@@ 米 部落 在 那里 由于 发现 了 金@@ 矿 人们 蜂@@ 拥@@ 而@@ 至
or if we go into the mountains of ti@@ bet , where i &apos;m doing a lot of research recently , you &apos;ll see it &apos;s a cru@@ de face of political dom@@ ination .	我们 再 来 看看 西@@ 藏 山@@ 区 最近 我 在 那里 做 了 大量 的 研究 在 那里 你 会 看到 政治 独@@ 裁 的 残@@ 酷 压@@ 迫
you know , gen@@ oci@@ de , the physical extin@@ ction of a people is univer@@ s@@ ally con@@ dem@@ ned , but eth@@ no@@ ci@@ de , the destruction of people &apos;s way of life , is not only not con@@ dem@@ ned , it &apos;s univer@@ s@@ ally , in many quarters , celebr@@ ated as part of a development strategy .	虽然 种族@@ 灭绝 在 全世界 受到 一致 的 谴@@ 责 但是 种族 文化 灭绝 也 就是 破坏 人们 的 生活 方式 的 行@@ 径 却 没有 受@@ 到@@ 谴@@ 责 在 很多 地方 它 甚至 被 视为 发展 战@@ 略 的 一部分 受到 赞@@ 扬
and you cannot understand the pain of ti@@ bet until you move through it at the ground level .	只要 你 亲@@ 自 去 那里 你 才能 体会 到 西@@ 藏 承受 的 痛@@ 楚
i once travel@@ led 6@@ ,000 miles from ch@@ eng@@ d@@ u in western china over@@ land through sou@@ the@@ a@@ stern ti@@ bet to l@@ ha@@ sa with a young colleag@@ ue , and it was only when i got to l@@ ha@@ sa that i understood the face behind the statistics you hear about : 6@@ ,000 sac@@ red mon@@ u@@ ments tor@@ n apart to dust and a@@ shes , 1.@@ 2 million people killed by the ca@@ dre@@ s during the cultural revolution .	我 和 一位 年轻 的 同事 从 中国 西@@ 北部 的 成@@ 都@@ 市 出发 经过 6 : 00 英里 的 旅程 穿过 西@@ 藏 的 东@@ 南@@ 地区 到达 拉@@ 萨 当 我 到达 拉@@ 萨 的 时候 才 真正 明白 你们 所 听说 过 的 那些 统计@@ 数字 背后 隐藏 的 真相 在 文@@ 化@@ 大@@ 革命 期间 6 : 00 座 神@@ 殿 庙@@ 宇 被 拆@@ 毁 120 万人 被 共@@ 产@@ 党 骨@@ 干@@ 分子 杀@@ 害
this young man &apos;s father had been as@@ cri@@ bed to the pan@@ chen la@@ ma .	这位 年轻人 的 父亲 皈@@ 依 班@@ 禅 喇@@ 嘛
that meant he was inst@@ antly killed at the time of the chinese inva@@ sion .	中国 人 入@@ 侵 后 他 立即 被 杀@@ 害 了
his un@@ cle f@@ led with his ho@@ lin@@ ess in the di@@ as@@ por@@ a that took the people to ne@@ p@@ al .	他 的 叔@@ 叔 和 其他 信@@ 徒 一起 逃@@ 亡 到 尼@@ 泊@@ 尔
his mother was in@@ car@@ cer@@ ated for the crime of being weal@@ thy .	他 的 母亲 因为 富@@ 农 家庭 成@@ 份 而 被 关@@ 押 起来
he was s@@ mu@@ gg@@ led into the jail at the age of two to hide bene@@ ath her sk@@ ir@@ t ta@@ ils because she couldn &apos;t bear to be without him .	那时 他 还 只有 两@@ 岁 他 的 母亲 悄@@ 悄@@ 地 把 他 藏 在 裙@@ 子 下面 把 他 带@@ 进 牢@@ 房 因为 她 不能 离开 她 的 儿子
the sister who had done that bra@@ ve de@@ ed was put into an education camp .	他 的 姐@@ 姐 因为 冒@@ 犯 行为 而 被 送@@ 入 学@@ 习@@ 班
one day she in@@ adver@@ t@@ ently ste@@ pped on an ar@@ mb@@ and of ma@@ o , and for that trans@@ gre@@ ssion , she was given seven years of hard labor .	有 一天 她 不 小心 踩 到 印@@ 有 毛@@ 主@@ 席 头@@ 像 的 臂@@ 章 而 被 处@@ 以 判@@ 国@@ 罪 接受 七@@ 年 劳@@ 教
the pain of ti@@ bet can be impossible to bear , but the re@@ de@@ mp@@ tive spirit of the people is something to be@@ hold .	西@@ 藏 的 痛@@ 楚 让 人 难以@@ 承受 人类 的 救@@ 赎 精神 需要 得到 见证
and in the end , then , it really comes down to a choice : do we want to live in a mon@@ o@@ chro@@ matic world of mon@@ ot@@ ony or do we want to embrace a poly@@ chro@@ matic world of diversity ?	到 最后 我们 将 面临 这样 一个 选择 我们 是 想要 生活 在 单一 的 世界 中 还是 需要 一个 五@@ 彩@@ 缤@@ 纷 、 多样@@ 化 的 世界
mar@@ gar@@ et me@@ ad , the great anthro@@ po@@ logist , said , before she died , that her greatest fear was that as we dri@@ fted towards this bl@@ and@@ ly am@@ or@@ ph@@ ous gener@@ ic world view not only would we see the entire range of the human imagination reduc@@ ed to a more nar@@ row mod@@ ality of thought , but that we would wake from a dream one day having for@@ gotten there were even other possibilities .	伟大 的 人类@@ 学家 mar@@ gar@@ et me@@ ad 在 生@@ 前 曾经 说 过 她 最 担心 的 事情 是 由于 我们 已经 走进 这种 无@@ 形 的 原@@ 生 世界@@ 观 我们 不仅 会 看到 人类 的 想@@ 像@@ 力 陷入 更 陕@@ 隘 的 思维 圈@@ 子 而且 某 一天 我们 一 觉@@ 醒 来 会 忘记 这个 世界 还有 其他 的 可能性
and it &apos;s hu@@ mb@@ ling to remember that our species has , perhaps , been around for &#91; 15@@ 0,000 &#93; years .	回 想起 我们 人类 已经 在世界上 存在 了 60 万年 这会 让 我们 感到 羞@@ 愧
the ne@@ o@@ li@@ th@@ ic revolution -- which gave us agriculture , at which time we suc@@ cu@@ mb@@ ed to the cul@@ t of the seed ; the poetry of the sha@@ man was dis@@ placed by the pro@@ se of the pri@@ es@@ tho@@ od ; we created hi@@ er@@ archy speci@@ alization sur@@ plus -- is only 10,000 years ago .	新@@ 石@@ 器 时代 革命 让 人类 进入 农业 时代 我们 对 种子 顶@@ 礼 腊@@ 拜 萨@@ 满 的 诗@@ 篇 被 祭@@ 司 的 箴@@ 言 抽 取代 我们 创造 了 层@@ 次@@ 化 的 社会@@ 分@@ 工 这 只 10 : 00 年前 的 事情
the modern industrial world as we know it is b@@ arely 300 years old .	现代@@ 化 的 工业 社会 只有 将近 三@@ 百@@ 年 的 历史
now , that sh@@ allow history doesn &apos;t suggest to me that we have all the answers for all of the challenges that will con@@ front us in the en@@ su@@ ing millen@@ nia .	在我看来 这个 短@@ 暂 的 历史 还 足以 让 我们 有 能力 解决 未来 千年 将 面临 的 各种 挑战
when these my@@ ri@@ ad cultures of the world are asked the meaning of being human , they respond with 10,000 different voices .	当 我们 向 这个 世界 的 不同 文化 询@@ 问 生命 的 意义 你 会 听到 10 : 00 种 不同 的 答案
and it &apos;s within that song that we will all re@@ discover the possibility of being what we are : a fully conscious species , fully aware of en@@ sur@@ ing that all peop@@ les and all gar@@ den@@ s find a way to fl@@ ouri@@ sh . and there are great moments of opti@@ mism .	在 歌@@ 声 中 ， 我们 将会 重新 发现 作为 人类 我们 有 另外 一种 可能性 ： 一个 有 完全 意识 的 物种 充@@ 分@@ 认识 到 我们 必须 保证 所有 种族 和 所有 生物 昌@@ 盛 繁荣 对 生活 充满 乐观
this is a photograph i took at the northern ti@@ p of ba@@ ff@@ in island when i went nar@@ wh@@ al hun@@ ting with some in@@ u@@ it people , and this man , o@@ la@@ y@@ u@@ k , told me a mar@@ vel@@ ous story of his grandfather .	这张 照片 是 我 在 巴@@ 芬@@ 岛 的 北部 山@@ 顶 上 拍摄 的 那时 我 和 一些 因@@ 纽 特@@ 人 去 捕 独@@ 角 鲸 这个 叫 奥@@ 拉 雅 的 人 向 我 讲述 了 一个 关于 他 的 祖父 的 传@@ 奇 故事
the can@@ adi@@ an government has not always been kind to the in@@ u@@ it people , and during the 195@@ 0s , to estab@@ lish our so@@ ver@@ ei@@ gn@@ ty , we forced them into sett@@ le@@ ments .	在 上 世纪 50 年代 加拿@@ 大@@ 政府 并 不是 一直 善@@ 待 因@@ 纽 特@@ 人 为了 建立 我们 的 主@@ 权@@ 国家 我们 将 他们 驱@@ 赶 到 指@@ 定 的 定@@ 居@@ 点
this old man &apos;s grandfather ref@@ used to go .	这位 老人 的 祖父 拒绝 迁@@ 移
the family , f@@ ear@@ ful for his life , took away all of his weapons , all of his tools .	他 的 家人 担心 他 的 安全 把 他 的 所有 武器 和 工具 都 拿走 了
now , you must understand that the in@@ u@@ it did not fear the cold ; they took advantage of it .	你们 都 知道 因@@ 纽 特@@ 人 不@@ 怕 冷 这是 他们 特@@ 天 独@@ 厚 的 优势
the run@@ ners of their sle@@ ds were origin@@ ally made of fish wra@@ pped in car@@ i@@ bo@@ u hide .	他们 的 雪@@ 橇 的 滑@@ 条 最初 是 用 北美 驯@@ 鹿 皮 包@@ 裹 的 冻 鱼 干 做成 的
so , this man &apos;s grandfather was not in@@ ti@@ mid@@ ated by the arctic night or the bli@@ zz@@ ard that was blo@@ wing .	这位 男子 的 祖父 并 不 惧@@ 怕 北极 的 夜晚 和 凛@@ 冽 的 暴@@ 风@@ 雪
he simply sli@@ pped outside , pulled down his se@@ al@@ skin tr@@ ous@@ ers and defe@@ cated into his hand . and as the fe@@ ces began to free@@ ze , he shaped it into the form of a bla@@ de .	他 睡 在 外面 穿着 他 的 海@@ 豹 皮 长@@ 裤 他 把 大@@ 便 拉 到 手上 等@@ 到 大@@ 便 快 变得 僵@@ 硬 的 时候 他 把 它 做成 刀@@ 片 的 形状
he put a sp@@ ray of s@@ ali@@ va on the edge of the sh@@ it k@@ ni@@ fe and as it finally fro@@ ze solid , he but@@ ch@@ ered a dog with it .	然后 在 这 把 屎 做成 的 刀@@ 片 边缘 吐@@ 上 口@@ 水 等 它 结@@ 冰 之后 变得 非常 坚@@ 固 之后 他@@ 用 这 把 刀@@ 子 宰@@ 杀 了 一条 狗
he sk@@ in@@ ned the dog and improvi@@ sed a har@@ ness , took the ri@@ b@@ ca@@ ge of the dog and improvi@@ sed a s@@ led , har@@ ne@@ ssed up an ad@@ jac@@ ent dog , and disappe@@ ared over the ice flo@@ es , sh@@ it k@@ ni@@ fe in be@@ lt .	剥@@ 下 狗@@ 皮 做成 一副 挽@@ 具 他 又 取出 狗 的 胸@@ 腔 做成 雪@@ 橇 套 到 另@@ 一只 狗 身上 腰@@ 间 别@@ 着 那 把 屎 做成 的 刀 消失 在 冰@@ 原 上
talk about getting by with nothing .	这 真是 空@@ 手 造 万@@ 物
and this , in many ways -- -- is a symbol of the resili@@ ence of the in@@ u@@ it people and of all indi@@ gen@@ ous people around the world .	从 很多 方面 来说 （ 鼓掌 ） 这是 因@@ 纽 特@@ 人 世界 上 的 所有 土@@ 著@@ 人 的 顽@@ 强 生命@@ 力 的 真实@@ 写@@ 照
the can@@ adi@@ an government in a@@ pri@@ l of 199@@ 9 gave back to total control of the in@@ u@@ it an area of land larger than california and texas put together .	199@@ 9 年 4 月 加拿@@ 大@@ 政府 将 一块 面积 比 加利福@@ 尼亚 和 德@@ 克@@ 萨@@ 斯 的 面积 之 和 还要 大 的 土地 重新 归@@ 还@@ 给 因@@ 纽 特@@ 人
it &apos;s our new hom@@ el@@ and . it &apos;s called n@@ un@@ a@@ v@@ u@@ t .	我 是 我们 的 新@@ 家园 它 的 名字 叫 纽@@ 勒 维@@ 特
it &apos;s an independent terr@@ it@@ ory . they control all min@@ eral resources .	这是 一块 独立 的 领@@ 土 他们 控制 那里 所有 的 海@@ 洋@@ 资源
an amazing example of how a na@@ tion-@@ state can see@@ k re@@ stitu@@ tion with its people .	这个 例子 很 好 地 说明 了 一个 国家 可以 有所@@ 作为 想 办法 修复 与 它 的 人民 之间 的 关系
and finally , in the end , i think it &apos;s pretty obvious at least to all of all us who &apos;ve travel@@ ed in these remote re@@ aches of the planet , to realize that they &apos;re not remote at all .	最后 我 认为 对于 曾经 去过 这个 世界 上 一些 偏@@ 远@@ 地区 的 人 来说 其实 那里 并 不 偏@@ 远
they &apos;re hom@@ el@@ ands of somebody .	因为 那里 是 某个 族@@ 类 的 家园
they represent bran@@ ches of the human imagination that go back to the da@@ wn of time . and for all of us , the dreams of these children , like the dreams of our own children , become part of the na@@ ked geo@@ graphy of hope .	他们 代表 着 人类 想象力 的 分@@ 支 可以 追@@ 溯到 最 远@@ 古 的 起源 时期 对于 我们 所有 的 人 来说 这些 孩子 们 的 梦想 与 我们 自己 的 孩子 们 的 梦想 一样 是 整个 世界 未来 希望 的 一部分
so , what we &apos;re trying to do at the national geo@@ graphic , finally , is , we believe that politicians will never ac@@ comp@@ lish anything .	因此 我们 要 通过 国家 地@@ 理@@ 杂志 和 电视@@ 台 所 做 的 事情 就是 我们 相信 政治家 不会 做出 成绩
we think that po@@ le@@ mics -- -- we think that po@@ le@@ mics are not per@@ su@@ a@@ sive , but we think that story@@ telling can change the world , and so we are probably the best story@@ telling institution in the world . we get 35 million hits on our website every month .	我们 认为 （ 鼓掌 ） 辩论 不是 为了 说服 别人 但是 我们 认为 通过 讲述 事实 可以 让 世界 得到 改@@ 观 因此 我们 可能 是 世界 上 最 擅长 讲述 事实 的 机构 我们 的 网站 每@@ 月 点击 量 达到 3 千 5 百万 次
15@@ 6 nations carry our television channel .	我们 的 电视@@ 频@@ 道 在 15@@ 6 个 国家 播放
our magaz@@ ines are read by millions .	我们 的 杂志 有 上@@ 百万 的 读者
and what we &apos;re doing is a series of jour@@ ne@@ ys to the eth@@ no@@ sphere where we &apos;re going to take our audience to places of such cultural wonder that they cannot help but come away da@@ zz@@ led by what they have seen , and hopefully , therefore , embrace gradu@@ ally , one by one , the central rev@@ el@@ ation of anthro@@ po@@ logy : that this world deser@@ ves to exist in a diver@@ se way , that we can find a way to live in a truly mul@@ tic@@ ul@@ tural , pl@@ ur@@ al@@ istic world where all of the wisdom of all peop@@ les can contribute to our collective well-being .	我们 要 做 的 是 通过 一系列 的 种族 圈 旅程 带领 我们 的 观众 去 领@@ 略 文化 奇迹 之@@ 地 他们 所 看到 的 一切 会 让 他们 情@@ 不@@ 自@@ 禁 地 感到 震@@ 撼 而且 我们 希望 他@@ 偿 逐渐 地 包@@ 容 和 接@@ 纳 这些 文化 人类@@ 学 的 核心 揭示 是 这个 世界 需要 多样@@ 化 的 生存 方式 让 我们 能够 真正 地 生活 在 一个@@ 多@@ 元 文化 的 世界 之中 让 所有 种族 的 智慧 能够 为 全@@ 人类 的 福@@ 址 做出 贡献
thank you very much .	谢谢
what i &apos;m going to show you first , as quickly as i can , is some foun@@ da@@ tional work , some new technology that we brought to microsoft as part of an acqui@@ si@@ tion almost exactly a year ago . this is se@@ ad@@ ra@@ g@@ on , and it &apos;s an environment in which you can either lo@@ cally or re@@ mot@@ ely interact with vast amounts of visual data .	首先 ， 我要 用 最快 的 速度 为 大家 演示 一些 新 技术 的 基础 研究@@ 成果 。 正好 是 一年 前 ， 微软 收@@ 购 了 我们 公司 ， 而 我们 为 微软 带来 了 这项 技术 ， 它 就是 se@@ ad@@ ra@@ g@@ on 。 se@@ ad@@ ra@@ g@@ on 是 一个 软件 环境 ， 你 可以 通过 它 以 近@@ 景 或 远@@ 景 的 方式 浏览 浩@@ 瀚 的 可@@ 视@@ 化 数据 。
we &apos;re looking at many , many gi@@ g@@ ab@@ y@@ tes of digital photos here and kind of se@@ am@@ lessly and continu@@ ously zo@@ om@@ ing in , pan@@ ning through the thing , re@@ ar@@ ran@@ ging it in any way we want .	我们 这里 看到 的 是 许多@@ 许多 g@@ b （ 千@@ 兆 字@@ 节 ） 级@@ 别 的 数@@ 码@@ 照片 ， 对 它们 可以 进行 持续 并且 平@@ 滑 的 放大 ， 可以 通过 全@@ 景 的 方式 浏览 它们 ， 还 可以 对 它们 进行 重新@@ 排列 。
and it doesn &apos;t matter how much information we &apos;re looking at , how big these collec@@ tions are or how big the images are .	不管 所 见到 的 数据 有 多少 、 图像 集@@ 有 多 大 以及 图像 本身 有 多 大 ， se@@ ad@@ ra@@ g@@ on 都 拥有 这样 的 处理 能力 。
most of them are ordinary digital camera photos , but this one , for example , is a scan from the library of congress , and it &apos;s in the 300 me@@ ga@@ pi@@ x@@ el range .	以上 展示 的 图片 大部分 都 是 由 数@@ 码@@ 相机 拍摄 的 照片 ， 但 这个 例子 则 不同 ， 它 是 一张 来自 国会 图书馆 的 扫描 图片 ， 拥有 3 亿@@ 个 像@@ 素 。
it doesn &apos;t make any difference because the only thing that ought to lim@@ it the performance of a system like this one is the number of pi@@ x@@ els on your screen at any given moment . it &apos;s also very flexible architecture .	然而 ， 浏览 它 并 没有 什么 区别 ， 因为 限制 系统 性@@ 能 的 唯一 因素 只是 ： 你 所 使用 的 屏幕 的 像@@ 素@@ 数 。 se@@ ad@@ ra@@ g@@ on 同时 也 是 一个 非常@@ 灵活 的 架@@ 构 。
this is an entire book , so this is an example of non-@@ image data .	举个 例子 ， 这是 一本 完整 的 书 ， 它 的 数据 是@@ 非 图像 的 。
this is &quot; b@@ lea@@ k house &quot; by di@@ ck@@ ens . every colum@@ n is a chapter .	这是 狄@@ 更@@ 斯 所@@ 著 的 《 荒@@ 凉 山@@ 庄 》 ， 一@@ 列 就是 一@@ 章 的 内容 。
to prove to you that it &apos;s really text , and not an image , we can do something like so , to really show that this is a real represen@@ tation of the text ; it &apos;s not a picture .	我 给 大家 证明 一下 这 真的 是 文@@ 本 而 非 图片 ， 我们 可以 这样 操作 ， 大家 可以 看出 这 真的 是 文@@ 本 ， 而 不是 一幅 图片 。
maybe this is a kind of an artificial way to read an e-@@ book .	也许 这会 是 一种 阅读 电子@@ 书 的 方式 ，
i wouldn &apos;t recomm@@ end it .	但是 我 可@@ 不 推@@ 荐 这么 做 。
this is a more real@@ istic case . this is an issue of the guar@@ dian .	接下来 是 一个 更加 实际 的 例子 ， 这是 一@@ 期 《 卫@@ 报 》 。
every large image is the beginning of a section .	每 一张 大 图片 是 一@@ 版 开@@ 篇 ，
and this really gives you the joy and the good experience of reading the real paper version of a magazine or a newspaper , which is an inher@@ ently multi-@@ scale kind of medium .	而 报纸 或者 杂志 的 纸@@ 质 版本 本身 就 包含 了 多种 比例 的 图片 ， 在 阅读 的 时候 ， 读者 会 得到 更好 的 阅读 体验 ， 从而 享受 阅读 的 乐趣 。
we &apos;ve also done a little something with the corner of this particular issue of the guar@@ dian .	我们 在 这里 做 了 小小的 改@@ 动 在 这 一@@ 期 《 卫@@ 报 》 得@@ 角 上 。
we &apos;ve made up a fake ad that &apos;s very high resolution -- much higher than you &apos;d be able to get in an ordinary ad -- and we &apos;ve embedded extra content .	我们 虚@@ 构 了 一个 高@@ 分@@ 辨@@ 率 的 广告 图片 — — 这@@ 比 你 平常 看到 的 普通 广告 的 分@@ 辨@@ 率 要 高 很多 ， 在 图片 中 嵌@@ 入 了 额外 的 内容 。
if you want to see the features of this car , you can see it here .	如果 你 希望 看到 这@@ 辆 车 的 特性 ， 你 可以 看 这里 。
or other models , or even technical speci@@ fi@@ cations .	你 还 能 看到 其他 的 型@@ 号 ， 甚至 技术 规@@ 格 。
and this really gets at some of these ideas about really doing away with those limits on screen real est@@ ate .	这种 方式 在 一定 程度 上 避免 了 屏幕 实际 使用 面积 的 限制 。
we hope that this means no more po@@ p@@ -@@ u@@ ps and other kind of ru@@ b@@ bi@@ sh like that -- shouldn &apos;t be necessary .	我们 希望 这个 技术 能够 减少 不@@ 必要 的 弹@@ 出 窗@@ 口 以及 类似 的 垃圾 信息 。
of course , ma@@ pping is one of those really obvious applications for a technology like this .	显然 ， 对于 这项 技术 的 应用 ， 数@@ 字@@ 地图 也 是 显而易见 的 应用 之一 。
and this one i really won &apos;t spend any time on , except to say that we have things to contribute to this field as well .	对此 ， 我 真的 不想 花费 太多 的 时间 进行 介绍 ， 我 只 想 告诉 大家 我们 已经 对 这个 领域 做出 了 自己 的 贡献 。
but those are all the roads in the u.s .	这些 只是 在 nasa 的 地理 空间 图片 基础 上
super@@ im@@ posed on top of a nasa geo@@ spa@@ tial image .	进行 叠@@ 加 处理 而 得到 的 美国 的 道路 地图 。
so let &apos;s pull up , now , something else .	现在 ， 我们 先 放@@ 下 这些 ， 看看 其他 的 。
this is actually live on the web now ; you can go check it out .	实际上 ， 这项 技术 已经 放到 网上 了 ， 大家 可以 自己 去 体验 一下 。
this is a project called photo@@ syn@@ th , which really mar@@ ries two different technologies .	这个 项目 叫 photo@@ syn@@ th ， 它 实际上 融合 了 两个 不同 的 技术 ：
one of them is se@@ ad@@ ra@@ g@@ on and the other is some very beautiful computer vision research done by no@@ ah sna@@ vely , a graduate student at the university of washington , co-@@ ad@@ vi@@ sed by steve se@@ it@@ z at u.@@ w .	一个 是 se@@ ad@@ ra@@ g@@ on ， 而 另 一个 则 是 源@@ 自 华盛@@ 顿@@ 大学 的 研究生 no@@ ah sna@@ vely 所 进行 的 计算机 视觉 研究 的 成果 。 这项 研究 还 得到 了 华盛@@ 顿@@ 大学 steve se@@ it@@ z
and ri@@ ck s@@ ze@@ li@@ sk@@ i at microsoft research . a very nice collaboration .	和 微软 研究@@ 院 ri@@ ck s@@ ze@@ li@@ sk@@ i 的 协@@ 助 。 这是 一个 非常 漂亮 的 合作 成果 。
and so this is live on the web . it &apos;s powered by se@@ ad@@ ra@@ g@@ on .	这个 项目 在 互联网 上 已经 得到 应用 了 ， 它 是 基于 se@@ ad@@ ra@@ g@@ on 技术 构建 的 。
you can see that when we kind of do these sorts of views , where we can di@@ ve through images and have this kind of multi-@@ resolution experience .	你 可以 看到 ， 我们 轻松 地 对 图片 进行 多种 方式 的 查看 ， 从而 能够 对 图片 进行 细@@ 致 的 剖@@ 析 并且 拥有 多 分@@ 辨@@ 率 的 浏览 体验 。
but the spa@@ tial ar@@ ran@@ gement of the images here is actually meaningful .	不过 ， 这些 图片 在 三@@ 维@@ 空间 的 排列 事实上 是 非常 有 意义 的 。
the computer vision algorithms have regi@@ ster@@ ed these images together so that they cor@@ respond to the real space in which these sh@@ ots -- all taken near gra@@ ss@@ i la@@ kes in the can@@ adi@@ an ro@@ ck@@ ies -- all these sh@@ ots were taken . so you see elements here of st@@ abi@@ lized sli@@ de-@@ show or pan@@ or@@ am@@ ic imag@@ ing , and these things have all been related spa@@ ti@@ ally .	计算机 视觉 算法 将 这些 图片 联系 到 一起 ， 那么 这些 图片 就 能够 将 真实 空间 呈现 出来 了 ， 而 我们 正是 在 这个 空间 里 拍 下 了 上述 的 照片 — — 这些 照片 都 是 在 加拿大 落@@ 基 山脉 的 格@@ 拉@@ 西 湖 （ gra@@ ss@@ i la@@ kes ） 附近 拍@@ 下 的 — — （ 所有 照片 ） 都 是 在 这里 拍@@ 下 的 。 因此 你 可以 看到 这里 的 元素 是 稳定 的 幻@@ 灯 放@@ 映 或者 全@@ 景 成像 ， 而 这些 内容 在 空间 上 都 是 关联 的 。
i &apos;m not sure if i have time to show you any other environments .	我 不 确定 我们 是否 有 时间 来 展示 更 多 的 环境 全@@ 景 。
there are some that are much more spa@@ tial .	有 很多 例子 比 这个 的 空@@ 间@@ 感 还要 强 。
i would like to jump straight to one of no@@ ah &apos;s original dat@@ a-@@ sets -- and this is from an early prototype of photo@@ syn@@ th that we first got working in the summer -- to show you what i think is really the pun@@ ch line behind this technology , the photo@@ syn@@ th technology . and it &apos;s not necessarily so ap@@ parent from looking at the environments that we &apos;ve put up on the website .	下面 让 我们 来看 一下 去年 夏天 ， 我们 利用 no@@ ah 早期 的 数据库 之一 所 photo@@ syn@@ th 的 初期 模型 的 建立 。 我 认为 这 可@@ 谓 是 我们 这项 技术 的 最 抢@@ 眼 之 处 。 这项 技术 不 单@@ 单 像 我们 在 网站 上 展示 得 那么 简@@ 单@@ 明@@ 了 。
we had to worry about the law@@ yers and so on .	主要 因为 我们 制作 网站 时 ， 要 顾@@ 及 到 很多 法律 问题 。
this is a re@@ construction of no@@ t@@ re da@@ me ca@@ the@@ dr@@ al that was done entirely compu@@ ta@@ tionally from images scra@@ ped from fli@@ ck@@ r . you just type no@@ t@@ re da@@ me into fli@@ ck@@ r , and you get some pictures of guys in t-@@ shir@@ ts , and of the cam@@ pus and so on . and each of these orange con@@ es represents an image that was discovered to be@@ long to this model .	这里 是 利用 fli@@ ck@@ r 网站 上 的 图像 重建 的 巴@@ 黎@@ 圣@@ 母@@ 院 。 你 所 要 做 的 只是 在 fli@@ ck@@ r 网站 上 输入 “ 巴@@ 黎@@ 圣@@ 母@@ 院 ” 然后 便 能 看到 很多 图片 ， 包括 留@@ 影 的 游@@ 人 等等 。 所有 这些 橘@@ 黄 颜色 的 锥@@ 形 都 代表 了 一张 用来 建立 模型 的 图片 。
and so these are all fli@@ ck@@ r images , and they &apos;ve all been related spa@@ ti@@ ally in this way .	这些 全部 是 来自 fli@@ ck@@ r 的 图片 ， 被 这样 在 空间 里 被 串@@ 联 起来 。
and we can just navi@@ gate in this very simple way .	接着 ， 我们 便 可 如此 自@@ 如 的 进行 浏览 。
you know , i never thought that i &apos;d end up working at microsoft .	（ 鼓掌 ） 说@@ 实@@ 话 ， 我 从来 没@@ 想 过 我会 最后 来 为 微软 工作
it &apos;s very gra@@ ti@@ fying to have this kind of re@@ ception here .	受到 这样 欢迎 ， 真@@ 挺 令人@@ 高兴 的 。
i guess you can see this is lots of different types of cameras : it &apos;s everything from cell phone cameras to professional s@@ l@@ r@@ s , quite a large number of them , sti@@ t@@ ched together in this environment .	我 想 你们 可以 看出 这些 图片 原 自 很多 不同 的 相机 ： 从 手机 摄像@@ 头 到 专业 单@@ 反 。 如此 大量 的 不同 质量 的 照片 ， 全 被 在 这个 环境 下 拼@@ 合 在 了 一起
and if i can , i &apos;ll find some of the sort of weird ones .	让 我 来 找@@ 些 比较 诡@@ 异 的 图片 。
so many of them are oc@@ clu@@ ded by faces , and so on .	看 ， 不少 照片 包含 了 游@@ 客 的 大@@ 头@@ 照 等等 。
somewhere in here there are actually a series of photographs -- here we go .	我 记得 这儿 应该 有 一个@@ 系列 的 照片 - 啊 ， 在 这儿 。
this is actually a pos@@ ter of no@@ t@@ re da@@ me that regi@@ ster@@ ed correc@@ tly .	这个 是 巴@@ 黎@@ 圣@@ 母@@ 院 的 海报 。
we can di@@ ve in from the pos@@ ter to a physical view of this environment .	我们 可以 钻 到 海报 里 去 看 整个 重建 的 环境 。
what the point here really is is that we can do things with the social environment . this is now taking data from everybody -- from the entire collective memory of , vi@@ sually , of what the earth looks like -- and link all of that together .	这里 的 重点 呢 便是 我们 可以 有效 地 利@@ 用@@ 网络 社区 。 我们 可以 从 每个 人 那里 得到 数据 将 每个 人 对 不同 环境 的 记忆 收集 在 一起 ， 共 建成 模型 。
all of those photos become linked together , and they make something emer@@ gent that &apos;s greater than the sum of the parts .	当 所有 这些 图片 交@@ 织 在 一起 时 ， 所 衍@@ 生 出 的 要 远远 超过 单@@ 单 收集 起 全部 。
you have a model that emer@@ ges of the entire earth .	这个 模型 所 衍@@ 生 出 的 ， 是 整个 地球 。
think of this as the long tail to ste@@ ph@@ en law@@ ler &apos;s virtual earth work .	这 如同 是 ste@@ ph@@ en law@@ ler 的 《 虚拟 地球 》 的 长@@ 尾 市场 。
and this is something that grows in complexity as people use it , and whose benefits become greater to the users as they use it .	这 类 模型 ， 会 随着 人们 的 使用 而 不断 变 的 复杂 ， 变得 更加 有 价值 。
their own photos are getting ta@@ gged with meta@@ -@@ data that somebody else entered .	用户 的 照片 ， 会 被 大家 注 上 标签 。
if somebody bo@@ ther@@ ed to ta@@ g all of these sa@@ ints and say who they all are , then my photo of no@@ t@@ re da@@ me ca@@ the@@ dr@@ al suddenly gets en@@ ri@@ ched with all of that data , and i can use it as an en@@ try point to di@@ ve into that space , into that meta@@ -@@ ver@@ se , using everybody else &apos;s photos , and do a kind of a cro@@ ss-@@ mod@@ al and cro@@ ss-@@ user social experience that way .	如果 有人 愿意 为 所有 这些 圣@@ 母@@ 院 里 的 圣@@ 贤 注 上 标签 ， 表明 他们 是 谁 ， 那 我们 的 圣@@ 母@@ 院 照片 便@@ 会 一@@ 下@@ 子 丰富 起来 ， 然后 呢 ， 我们 便 能 以 这张 照片 为 起@@ 点 ， 进入 这个 空间 ， 这个 由 很多 人 的 照片 所 搭建 的 虚拟@@ 世界 ， 从而 得到 一种 跨越 模型 ， 跨越 用户 的 交互 体验 。
and of course , a by-@@ product of all of that is im@@ men@@ sely rich virtual models of every interesting part of the earth , collected not just from over@@ head f@@ lights and from satellite images and so on , but from the collective memory .	当然 了 ， 这 一切 所 带来 另外 一个 宝@@ 贵 产物 便是 一个 非常 丰富 的 模型 - 充@@ 斥 这 地球 每个 角@@ 落@@ 里 有趣 的 景观 。 这些 景观 不再 局@@ 限于 航@@ 空 和 卫星 图片 ， 而是 实@@ 实@@ 在@@ 在 的 人们 按@@ 下 快@@ 门 一刻 所 收@@ 藏 的 记忆 的 集@@ 合 。
thank you so much .	非常感谢 ！
do i understand this right ? that what your software is going to allow , is that at some point , really within the next few years , all the pictures that are shared by anyone across the world are going to basically link together ?	如果 我 理解 正确 的话 ， 你们 的 这个 软件 将 能够 在 未来 的 几年 内 将 来自 全球 的 图片 接 合@@ 在一起 ？
yes . what this is really doing is disco@@ vering .	是 的 。 这个 软件 的 真正 意义 便是 去 探索 。
it &apos;s creating hyper@@ links , if you will , between images .	它 在 图片 间 构建 起 超@@ 链接 。
and it &apos;s doing that based on the content inside the images .	这个 接@@ 合 的 过程 完全 是 基于 图片 的 内容 。
and that gets really exciting when you think about the rich@@ ness of the se@@ man@@ tic information that a lot of those images have .	更 令人@@ 兴奋 的 在于 图片 所 包含 的 大量 文字 语@@ 义 信息 。
like when you do a web search for images , you type in phra@@ ses , and the text on the web page is carrying a lot of information about what that picture is of .	比如 ， 你 在 网上 所以 一张 图片 ， 键@@ 入 关键@@ 词 后 ， 网页 上 的 文字 内容 将 包含 大量 与 这个 图片 相关 的 信息 。
now , what if that picture links to all of your pictures ?	现在 ， 假设 这些 图片 全都 与 你 的 图片 相连 ， 那 将 会 怎样 ？
then the amount of se@@ man@@ tic inter@@ connection and the amount of rich@@ ness that comes out of that is really huge . it &apos;s a classic network effect .	那时 ， 所以 这些 语@@ 义 信息 的 相互 链接 以及 内容 量 将 是 巨大 的 。 这 将 是 非常 典型 的 网络 效应 。
bla@@ ise , that is truly incredible . con@@ gr@@ at@@ u@@ lations .	bla@@ ise ， 太 难以置信 了 。 祝@@ 贺 你们 ！
thanks so much .	非常感谢 各位 ！
i &apos;m going to talk to you about some stuff that &apos;s in this book of mine that i hope will res@@ on@@ ate with other things you &apos;ve already heard , and i &apos;ll try to make some connections myself , in case you miss them .	我 想 在 这里 谈谈 我 这 本书 里 的 部分 内容 希望 它 和 你们 已经 听到 过 的 一些 事物 引@@ 起@@ 共鸣 如果 有 哪些 你们 不 清楚 的 我 在 这里 会@@ 试 着 帮 你 把 它们 联系 起来 。
i want to start with what i call the &quot; official do@@ g@@ ma . &quot;	我 想 从 一个 公@@ 认 的 信@@ 条 讲 起 。
the official do@@ g@@ ma of what ?	什么样 的 公@@ 认 的 信@@ 条 呢 ？
the official do@@ g@@ ma of all western industrial societies .	就是 整个 西方 工业 社会 所 笃@@ 信 不@@ 疑 的 一个 信@@ 条 。
and the official do@@ g@@ ma runs like this : if we are interested in ma@@ xi@@ mi@@ zing the wel@@ f@@ are of our citizens , the way to do that is to ma@@ xi@@ mi@@ ze individual freedom .	这个 信@@ 条 是 这么 说 的 ： 如果 我们 要 想 使 民众 获得 最大 限@@ 度 的 福利 ， 其 方法 就是 使 个人 自由 达到 最@@ 大@@ 化 。
the reason for this is both that freedom is in and of itself good , valuable , wor@@ th@@ while , essential to being human .	原因 就是 自由 这 东西 在 与 本身 就是 美好 的 ， 具有 价值 ， 为 人们 所 必@@ 需 。
and because if people have freedom , then each of us can act on our own to do the things that will ma@@ xi@@ mi@@ ze our wel@@ f@@ are , and no one has to decide on our be@@ half .	另外 ， 一旦 人们 有 了 自由 ， 我们 每个 人 都 可以 自己 做@@ 主 用 各种 办法 最大 限@@ 度 地 获得 福利 ， 用@@ 不@@ 着 别人 来 替 我们 做@@ 主 。
the way to ma@@ xi@@ mi@@ ze freedom is to ma@@ xi@@ mi@@ ze choice .	使 自由 达到 极大 化 的 途径 就是 最大 限@@ 度 的 增加 选@@ 择@@ 性 。
the more choice people have , the more freedom they have , and the more freedom they have , the more wel@@ f@@ are they have .	人们 的 选择 越 多 ， 自由 也 就 越 多 ， 自由 越 多 ， 得到 的 福利 也 就 越 多 。
this , i think , is so deeply embedded in the water supply that it wouldn &apos;t occur to anyone to question it .	我 觉得 ， 这个 观念 就 像 掺@@ 进 了 我们 的 自@@ 来@@ 水 里 那样 根@@ 深@@ 蒂@@ 固 以至于 没人 想 起来 会 对 它 提出 疑问 。
and it &apos;s also deeply embedded in our lives .	同样 这个 观念 也 深@@ 嵌 于 我们 的 日常生活 之中 。
i &apos;ll give you some examples of what modern progress has made possible for us .	我来 给 你们 举@@ 些 例子 看看 当@@ 代 社会 的 进步 发展 让 我们 变得 有 可能 做些 什么 事 。
this is my super@@ market . not such a big one .	这是 我@@ 家 附近 的 一个 超市 。 不@@ 算 很大 。
i want to say just a word about sal@@ ad dre@@ ssing .	我 只 想 说 说 这里 的 色@@ 拉 调@@ 料 。
17@@ 5 sal@@ ad dre@@ s@@ sin@@ gs in my super@@ market , if you don &apos;t count the 10 extra@@ -@@ virg@@ in o@@ live o@@ ils and 12 bal@@ sa@@ mic v@@ ine@@ gar@@ s you could buy to make a very large number of your own sal@@ ad dre@@ s@@ sin@@ gs , in the off@@ -@@ chance that none of the 17@@ 5 the store has on offer suit you .	我 这@@ 家 超市 有 17@@ 5 种 各@@ 式 色@@ 拉 调@@ 料 ， 还 没@@ 算 上 10 种 不同 牌@@ 子 的 特@@ 级 初@@ 榨 橄@@ 榄@@ 油 和 12 种 bal@@ sa@@ mic 葡@@ 萄 醋@@ 任 你 选@@ 购 ， 如果 碰@@ 巧 那 17@@ 5 种 色@@ 拉 酱 都 不 和 你 的 口@@ 味 ， 你 就 可以 用 它们 调@@ 出 另 一大@@ 批 你 自己 的 色@@ 拉 酱 。
so this is what the super@@ market is like .	你 看 ， 这 就是 超@@ 级@@ 市场 的 样子 。
and then you go to the consumer electronics store to set up a ster@@ e@@ o system -- speakers , c@@ d player , tape player , tun@@ er , am@@ pli@@ fi@@ er -- and in this one single consumer electronics store , there are that many ster@@ e@@ o systems .	然后 你 转@@ 身 出来 到 一家 家@@ 用@@ 电@@ 器 店@@ 去 配@@ 置 一套 立@@ 体@@ 音@@ 响 系统 - 音@@ 箱 啦 ， c@@ d@@ 机 啦 ， 磁@@ 带@@ 机 ， 收@@ 音@@ 机 ， 放@@ 大@@ 器 。 就 这么 一家 家@@ 用@@ 电@@ 器 店@@ 里 立@@ 体@@ 音@@ 响 系统 就 多 得 数@@ 不@@ 清 。
we can construc@@ t six@@ -and-@@ a-@@ half-@@ million different ster@@ e@@ o systems out of the components that are on offer in one store .	用 这@@ 家 店 的 组@@ 件 你 可以 配@@ 出 近 6@@ 50 万@@ 种 各种 组合 的 立@@ 体@@ 音@@ 响 系统 来 。
you &apos;ve got to admit that &apos;s a lot of choice .	你 没法 不 承认 这 可是 不@@ 小 的 一堆 选择 吧 。
in other dom@@ a@@ ins -- the world of communi@@ cations .	换@@ 个 行业 ， 说 说 通讯 。
there was a time , when i was a boy , when you could get any kind of telephone service you wanted , as long as it came from ma bell .	我 还是 孩子 那@@ 会儿 ， 你 要 想 接@@ 通 电话 服务 ， 那 就 得 去 玛 贝@@ 尔 公司 ， 只@@ 此@@ 一家 。
you ren@@ ted your phone . you didn &apos;t buy it .	你 不用 买 ， 只 需@@ 去 租 一@@ 架 电@@ 话@@ 机 回来 。
one con@@ sequence of that , by the way , is that the phone never broke .	通常 情况 是 ， 那 电话 用到 死 都 不会 坏 。
and those days are gone .	那种 日子 早@@ 已 一@@ 去@@ 不@@ 返 了 。
we now have an almost un@@ limited variety of phones , especially in the world of cell phones .	如今 我们 几乎 有 无@@ 穷@@ 无@@ 尽 的 电话 品@@ 种 ， 尤其 是 手机 。 ( 显示 漫画 ）
these are cell phones of the future .	这些 都 是 未来 的 手机 。
my favorite is the middle one -- the mp@@ 3 player , nose hair tri@@ m@@ mer , and cre@@ me bru@@ lee tor@@ ch .	其中 我 最 津@@ 津@@ 乐@@ 道 的 是 中间 那 款 - 带 着 mp@@ 3 播@@ 放@@ 机 ， 鼻@@ 毛 剪 和 法@@ 式 焦@@ 糖 布@@ 丁 的 喷@@ 火 枪 。
and if by some chance you haven &apos;t seen that in your store yet , you can rest assu@@ red that one day soon you will .	如果 你 还 没 在 你@@ 家 旁边 的 商店 里 见 过 的话 ， 不必 担心 ， 用 不了 多久 你 就 会 看到 的 。
and what this does is it leads people to walk into their stores asking this question .	这@@ 事 的 结果 是 ， 人们 跑 到 商店 里 问 ： （ 你们 有没有 一@@ 款 不@@ 带 这么 多@@ 功能 的 ？ ）
and do you know what the answer to this question now is ?	你 想 ， 回答 会 是 什么 ？
the answer is &quot; no . &quot;	回答 是 “ 没有 ” 。
it is not possible to buy a cell phone that doesn &apos;t do too much .	如今 你 已经 不 可能 买 到 一@@ 款 不@@ 干 那么 多@@ 事 的 手机 。
so , in other aspects of life that are much more significant than buying things , the same explo@@ sion of choice is true .	同样 ， 在 生活 里 的 其它 一些 比 购@@ 物 更 对 我们 产生 影响 事情 上 ， 这种 选择 的 爆炸 同样 存在 。
health care -- it is no longer the case in the united states that you go to the doctor , and the doctor tells you what to do .	医疗@@ 保健 - 在 美国 ， 现在 早@@ 已 不是 那种 你 去 看 医生 ， 医生 直@@ 截@@ 了@@ 当 告诉 你 该 如何 做 的 时代 了 。
instead , you go to the doctor , and the doctor tells you , &quot; well , we could do a , or we could do b .	相反 ， 你 到 了 医生 那里 ， 医生 会 对 你 说 ： 我们 可以 用 治疗 方案 甲 ， 也 可以 用 方案 乙
a has these benefits , and these risks .	方案 甲@@ 有 如@@ 此@@ 这@@ 般 疗@@ 效 和 风险 。
b has these benefits , and these risks . what do you want to do ? &quot;	方案 乙@@ 有 如@@ 此@@ 这@@ 般 疗@@ 效 和 风险 。 你 想 怎么 治 ？
and you say , &quot; do@@ c , what should i do ? &quot;	然后 你 说 ： “ 大@@ 夫 ， 我@@ 该 如何 做 ？ ”
and the do@@ c says , &quot; a has these benefits and risks , and b has these benefits and risks .	医生 又 说 一遍 ， 甲@@ 有 这些 疗@@ 效 和 风险 ， 乙@@ 有 那些 疗@@ 效 和 风险 。
what do you want to do ? &quot;	你 想 怎么 治 ？
and you say , &quot; if you were me , do@@ c , what would you do ? &quot;	你 再 问 医生 ： “ 大@@ 夫 ， 你 要是 我 ， 你 选 那种 ？ ”
and the do@@ c says , &quot; but i &apos;m not you . &quot;	医生 说 ： “ 但是 我 不是 你 。 ”
and the result is -- we call it &quot; patient auton@@ omy , &quot; which makes it sound like a good thing , but what it really is is a shi@@ fting of the bur@@ den and the responsibility for deci@@ sion@@ -@@ making from somebody who knows something -- na@@ mely , the doctor -- to somebody who knows nothing and is almost certainly sick and th@@ us not in the best shape to be making decisions -- na@@ mely , the patient .	其 结果 就是 我们 所说 的 “ 病人 自@@ 治 。 ” 听 起来 好像 挺@@ 不错 的 。 其实 是 把 做 决定 的 担@@ 子 和 责任 从 一个 知道 该 怎么 做 的 人 我 指 的 是 医生 ， 转@@ 嫁@@ 到 一个 对 治疗 方案 一无@@ 所知 ， 而且 正在 为 病@@ 痛 所 困扰 ， 根本 不 在 能 做 决定 的 状态 的 人 身上 ， 那 人 就是 病人 。
there &apos;s enormous marketing of pre@@ scrip@@ tion drugs to people like you and me , which , if you think about it , makes no sense at all , since we can &apos;t buy them .	现在 那些 处@@ 方 药品 的 广告 铺@@ 天@@ 盖@@ 地 ， 都 是 针对 着 你 我 这些 普通@@ 人 的 。 你 如果 仔细 想想 ， 一点 也 说 不通 。 既然 我们 不能 直接 去 柜@@ 台 买 ，
why do they market to us if we can &apos;t buy them ?	他们 为什么 还要 向 我们 做 市场 宣传 ？
the answer is that they expect us to call our doctors the next morning and ask for our pre@@ scrip@@ tions to be changed .	回答 是 ， 他们 希望 我们 看 了 广告 后 第二天 早上 会 去 给 自己 的 医生 打电话 ， 让 医生 把 处@@ 方 上 的 药 换成 他们 的 。
something as dramatic as our identity has now become a matter of choice , as this slide is meant to indi@@ cate .	如今 像 我们 的 性别 身份 这类 的 事 都 成 了 选择 的 话题 了 。 就 像 这张 幻灯片 试图 说明 的 那样 。
we don &apos;t inher@@ it an identity ; we get to invent it .	现在 我们 的 性别 不是 从 父母 那里 继@@ 承 下来 ， 而是 由 自己 来 发明 。
and we get to re-@@ invent ourselves as often as we like .	这样 我们 就 可以 随@@ 心@@ 所@@ 欲 地 的 重新 塑造 自己 的 性别 身份 。
and that means that everyday , when you wake up in the morning , you have to decide what kind of person you want to be .	这 也 意@@ 味 每天 早上 你 醒@@ 来 你 先@@ 得 对 今天 你 想 做 个 什么样 的 人 （ 男 的 还是 女 的 ） 做出 决定 。
with respect to marriage and family , there was a time when the de@@ fa@@ ult assu@@ mption that almost everyone had is that you got married as soon as you could , and then you started having kids as soon as you could .	在 婚@@ 姻@@ 家庭 方面 ， 在 过去 每个 人@@ 到 了 年龄 就 结婚 这 几乎 是 理所@@ 当然 的 事 ， 然后 就是 尽@@ 快 生@@ 儿@@ 育@@ 女 。
the only real choice was who , not when , and not what you did after .	唯一 你 需要 选择 的 就是 和 谁 结婚 ， 而 不是 什么 时候 结 ， 也 不是 结婚 以后 做 什么 。
now@@ ad@@ a@@ ys , everything is very much up for gr@@ ab@@ s .	而 如今 呢 ， 所有 的 事 都 可以 拿@@ 来 挑@@ 挑@@ 拣@@ 拣 。
i teach wonder@@ fully intelligent students , and i as@@ sign 20 percent less work than i used to .	我@@ 教 的 是 一群 优秀 又 聪明 的 学生 ， 可是 现在 我 给 他们 布@@ 置 的 作业 比 从前 少 了 五@@ 分之一 。
and it &apos;s not because they &apos;re less smart , and it &apos;s not because they &apos;re less di@@ lig@@ ent .	这 不是 因为 他们 （ 比 以前 的 学生 ） 笨 ， 也 不是 因为 他们 不 那么 勤@@ 奋 。
it &apos;s because they are pre@@ occu@@ pi@@ ed , asking themselves , &quot; should i get married or not ? should i get married now ?	原因 是 他们 现在 脑@@ 子 都 装@@ 满 了 各种 事情 ， 总是 在 问 自己 ： 我 到底 该 结婚 还是 不该 结婚 ？ 是 该 现在 结 ？
should i get married later ? should i have kids first , or a career first ? &quot;	还是 以后 再@@ 说 ？ 我 是 该 先@@ 要 孩子 ， 还是 先@@ 顾 事业 ？
all of these are consu@@ ming questions .	这些 都 是 费 脑@@ 筋 的 问题 。
and they &apos;re going to answer these questions , whether or not it means not doing all the work i as@@ sign and not getting a good grade in my cour@@ ses .	这些 问题 他们 都 必须 回答 ， 不论 他们 是 做 还是 不 做 我 布@@ 置 的 功@@ 课 ， 也 不论 他们 在 我 的 课@@ 上 拿@@ 个 什么 成绩 。
and indeed they should . these are important questions to answer .	他们 的确 应该 去 想 这些 问题 ， 因为 这 都 是 些 重要 问题 。
work -- we are ble@@ ssed , as car@@ l was poin@@ ting out , with the technology that en@@ ables us to work every minute of every day from any place on the planet -- except the ran@@ dol@@ ph hotel .	如今 做 工作 ， 像 卡@@ 尔 先@@ 前 说 的 ， 我们 真的 是 有@@ 福@@ 气 ， 技术 的 进步 使得 我们 可以 在 一天 的 任何 时间 ， 在 地球 的 任@@ 一 角落 工作 - 当然 这个 篮@@ 道@@ 夫 旅@@ 店 除@@ 外 。
there is one corner , by the way , that i &apos;m not going to tell anybody about , where the wi@@ f@@ i works .	但是 ， 这个 饭@@ 店 里 的确 有 一个 地方 可以 无@@ 线 上网 ， 可 我 不会 告诉 你们 在 哪 ，
i &apos;m not telling you about it because i want to use it .	不 告诉 你 的 理由 是 我 也 想 用 。
so what this means , this incredible freedom of choice we have with respect to work , is that we have to make a decision , again and again and again , about whether we should or shouldn &apos;t be working .	话@@ 说@@ 回来 ， 我们 工作 中 的 这些 难以置信 的 选择 自由 给 我们 带来 的 就是 我们 必须 在 选择 中 做出 决定 ， 一次 ， 一次 ， 又 一次 地 ， 为 自己 现在 该 工作 还是 该 休息 左@@ 右@@ 摇@@ 摆 。
we can go to watch our kid play so@@ c@@ cer , and we have our cell phone on one hi@@ p , and our black@@ ber@@ ry on our other hi@@ p , and our laptop , pre@@ su@@ ma@@ bly , on our la@@ ps .	我们 去 看 孩子 踢@@ 足@@ 球 的 时候 一个 裤@@ 兜 里@@ 装 着 手机 ， 另 一个 裤@@ 兜 里@@ 装 着 黑@@ 莓 （ black@@ ber@@ ry ） ， 膝@@ 上 还 架 着 笔记本电脑 。
and even if they &apos;re all shut off , every minute that we &apos;re watching our kid mu@@ ti@@ late a so@@ c@@ cer game , we are also asking ourselves , &quot; should i answer this cell phone call ?	即使 它们 都 关@@ 着 ， 我们 还是 在 看着 孩子 在 场@@ 上 争@@ 抢 的 同时 不断 地@@ 问 自己 ， 接 还是 不@@ 接 这个 电话 ？
should i respond to this email ? should i dra@@ ft this letter ? &quot;	回 还是 不@@ 回 这个 email ？ 我 该@@ 不该 写 这 封@@ 信 稿 ？
and even if the answer to the question is &quot; no , &quot; it &apos;s certainly going to make the experience of your kid &apos;s so@@ c@@ cer game very different than it would &apos;ve been .	即使 你 给 自己 的 回答 是 不 ， 你 对 孩子 的 这场 球@@ 赛 的 体验 还是 还是 大@@ 打@@ 折@@ 扣 。
so everywhere we look , big things and small things , material things and lifestyle things , life is a matter of choice .	环@@ 顾@@ 四@@ 周 ， 不论 大@@ 事 还是 小@@ 事 ， 物质 的 还是 生活 方式 方面 ， 生活 就是 选择 。
and the world we used to live in looked like this .	我们 过去 生活 的 世界 是 这样 的 。
that is to say , there were some choices , but not everything was a matter of choice .	就是说 ， 选择 还是 有 的 ， 但 不是 事@@ 事 都 需要 选择 。
and the world we now live in looks like this .	而 今天 我们 生活 的 世界 则 是 这样 的 。
and the question is , is this good news , or bad news ?	问题 是 ， 这 到底 是 好事 还是 坏@@ 事 ？
and the answer is yes .	答案 是 肯定 的 。
we all know what &apos;s good about it , so i &apos;m going to talk about what &apos;s bad about it .	我们 都 知道 它 的 好处 。 那么 就让 我 来说 说 它 的 不好 之处 吧 。
all of this choice has two effects , two negative effects on people .	所有 这些 选择 对 人们 有 两个 影响 ， 而且 是 两个 负面 的 影响 。
one effect , para@@ do@@ x@@ ically , is that it produces paraly@@ sis , rather than liber@@ ation .	其@@ 一 ， 说 起来 有些 自@@ 相@@ 矛盾 ， 就是 ， （ 选择 ） 给 我们 带来 的 不是 解放 ， 而是 束@@ 缚 ， 是 麻@@ 痹 。
with so many options to choose from , people find it very difficult to choose at all .	面对 这么 许多 的 选择 人们 发现 要 做出 决定 非常 困难 。
i &apos;ll give you one very dramatic example of this : a study that was done of invest@@ ments in volun@@ tary reti@@ rement plans .	让 我 给 你 举个 非常 生@@ 动 的 例子 来 说明 这点 ， 这是 一个 关于 对 等 退@@ 休@@ 金 计划 投资 方面 做 的 调查 。
a colleag@@ ue of mine got access to investment records from van@@ gu@@ ard , the gi@@ gan@@ tic mu@@ tual fund company of about a million employees and about 2,000 different work@@ places .	我 的 一个 同事 有幸 接触 到 van@@ gu@@ ard 的 投资 记录 。 van@@ gu@@ ard 是 一家 巨大 的 互@@ 助 基金 公司 ， 拥有 约 百万 员工 和 2 , 000 多个 办@@ 公 地点 。
and what she found is that for every 10 mu@@ tual fun@@ ds the emplo@@ yer offered , rate of particip@@ ation went down two percent .	她 的 调查 发现 是 当 这些 客户 （ 向 他们 的 雇@@ 员 ） 提供 的 互@@ 助 基金 种类 每 增加 10 个 参加 的 人数 就 减少 2 个 百分@@ 点 。
you offer 50 fun@@ ds -- 10 percent fewer employees participate than if you only offer five . why ?	你 提供 50 种 基金 ， 雇@@ 员 参加 的 人数 比 你 提供 5 种 基金 时 下降 百分之@@ 十 。 为什么 呢 ？
because with 50 fun@@ ds to choose from , it &apos;s so dam@@ n hard to decide which fund to choose that you &apos;ll just put it off until tomorrow .	因为 面对 50 种 基金 来 选择 想要 决定 选 那种 那 简直 是 难@@ 上@@ 加@@ 难 所以 你 干@@ 脆 放到 明天 再@@ 说 。
and then tomorrow , and then tomorrow , and tomorrow , and tomorrow , and of course tomorrow never comes .	明@@ 日 复@@ 明 日 ， 明@@ 日 何@@ 其 多 ， 当然 ， 明天 永远 也 不会 到来 。
understand that not only does this mean that people are going to have to eat dog food when they reti@@ re because they don &apos;t have enough money put away , it also means that making the decision is so hard that they pass up significant mat@@ ching money from the emplo@@ yer .	我们 知道 这 其实 意味着 当 人们 退休 时 ， 可能 只有 用 狗 粮 充@@ 饥 ， 因为 他们 没有 划@@ 出 足够 的 钱 给 将来 ， 同时 ， 由于 做 决定 是 一件 如此 之@@ 难 的 事 ， 以至于 连 雇@@ 主 给 他们 的 那@@ 笔 相当@@ 可@@ 观 的 对 等 补@@ 助@@ 金 都 白@@ 白 放弃 了 。
by not particip@@ ating , they are passing up as much as 5,000 dollars a year from the emplo@@ yer , who would happ@@ ily match their contribu@@ tion .	不 参加 这种 对 等 计划 ， 他们 每年 让 多@@ 达 5 千@@ 元 的 雇@@ 主 对 等 补@@ 贴 从 手@@ 边 溜@@ 掉 。 雇@@ 主 本来 是 很 乐@@ 于 提供 这种 补@@ 贴 的 。
so paraly@@ sis is a con@@ sequence of having too many choices .	所以 ， 选择 可能性 过@@ 多 的 结果 是 麻@@ 痹 僵@@ 化 。
and i think it makes the world look like this .	它 使得 我们 的 世界 变成 这样 样子 （ 幻灯片 显示 漫画 ）
you really want to get the decision right if it &apos;s for all e@@ ter@@ n@@ ity , right ?	当 你 进入 极@@ 乐@@ 世界 时 ， 你 一定 很 希望 你 做出 的 决定 是 正确 的 ， 是不是 ？
you don &apos;t want to pick the wrong mu@@ tual fund , or even the wrong sal@@ ad dre@@ ssing .	在 那里 你 一定 不想 再 选@@ 错 互@@ 助 基金 ， 或者 是 沙@@ 拉 调@@ 料 。
so that &apos;s one effect . the second effect is that even if we manage to overcome the paraly@@ sis and make a choice , we end up less satis@@ fied with the result of the choice than we would be if we had fewer options to choose from .	刚才 那 是 第一个 （ 负面 ） 影响 。 再 来说 说 第二个 。 即使 我们 通过 努力 克服 了 僵@@ 化 和 麻@@ 痹 而 终于 做出 了 一个 正确 的 决定 ， 我们 对 自己 的 做出 的 决定 反而 不如 可@@ 选@@ 性 少@@ 时 做出 的 决定 更加 满意 。
and there are several reasons for this .	这里 有 几个 原因 。
one of them is that with a lot of different sal@@ ad dre@@ s@@ sin@@ gs to choose from , if you buy one , and it &apos;s not perfect -- and , you know , what sal@@ ad dre@@ ssing is ? -- it &apos;s easy to imagine that you could have made a different choice that would have been better . and what happens is this imag@@ ined alternative in@@ duc@@ es you to regre@@ t the decision you made , and this regre@@ t sub@@ trac@@ ts from the satis@@ fac@@ tion you get out of the decision you made , even if it was a good decision .	其中 之一 是 ， 面对 如此 多 的 沙@@ 拉 调@@ 料 品@@ 种 ， 如果 你 买 了 一种 ， 觉得 不 尽@@ 如@@ 人@@ 意 ， 你 很 容易 去 想象 如果 你 挑 另外 一种 就 好 了 。 结果 怎么样 ？ 这种 想象 中 的 另外 选择 引@@ 得 你 对 你 已经 做出 的 决定 感到 后@@ 悔 ， 这种 后@@ 悔 心@@ 情 让 你 对 你 原@@ 先 做出 的 选择 的 满@@ 意@@ 度 打 了 折@@ 扣 ， 即便 那 其实 是 个 很 不错 的 选择 。
the more options there are , the easier it is to regre@@ t anything at all that is disa@@ p@@ poin@@ ting about the option that you chose .	选择 越 多 ， 就 越 容易 莫@@ 名@@ 其@@ 妙 地 对 一些 事 感到 后@@ 悔 。 这 就是 其@@ 一 ， 总是 不 满意 自己 做出 的 选择 决定 。
second , what economists call &quot; opportunity costs . &quot;	其@@ 二 ， 是 经济学家 称之为 “ 机@@ 会@@ 成本 ” 的 东西 。
dan gil@@ bert made a big point this morning of talking about how much the way in which we value things depends on what we compare them to .	今天 早@@ 些@@ 时候 丹 。 吉@@ 尔@@ 伯特 讲 了 个 大@@ 道理 就是 ， 我们 看 一个 东西 的 价值 取决于 那些 我们 用来 作 比较 的 那些 其他 的 东西 。
well , when there are lots of alter@@ na@@ tives to consider , it is easy to imagine the attrac@@ tive features of alter@@ na@@ tives that you re@@ ject , that make you less satis@@ fied with the alternative that you &apos;ve cho@@ sen .	嗯 ， 当 人们 有 很多 选择 可以 考虑 时 ， 就 很 容易 去 想象 那些 你 放弃 了 的 选择 的 吸引 人 的 方面 。 这 就 使得 你 总是 对 你 选@@ 中 了 的 那个 觉得 美@@ 中@@ 不足 。
here &apos;s an example . for those of you who aren &apos;t new yor@@ kers , i apo@@ logi@@ ze .	举个 例子 吧 （ 显示 漫画 ） ， 不过 你 如果 不是 纽约 人 的话 ， 我 先@@ 道 个 歉
but here &apos;s what you &apos;re supposed to be thinking .	但 这 是 你 此@@ 时@@ 此刻 应该 想 的 事 。
here &apos;s this couple on the ha@@ mp@@ tons .	看看 汉@@ 普@@ 顿 的 这 两@@ 口@@ 子 ，
very expensive real est@@ ate .	昂贵 的 富@@ 人 区 ，
gor@@ geous beach . beautiful day . they have it all to themselves .	华@@ 丽 的 海@@ 滩 ， 阳@@ 光@@ 明@@ 媚 ， 他们 拥有 这 一切 。
what could be better ? &quot; well , dam@@ n it , &quot; this guy is thinking , &quot; it &apos;s au@@ gu@@ st .	还 能@@ 比 这 更好 么 ？ 这位 此时 却 在 想 “ 哼 ， 真 倒@@ 霉 ， ” “ 现在 是 八@@ 月 啊 ， ”
everybody in my manhattan neighborhood is away .	“ 曼哈@@ 顿 的 邻@@ 居@@ 们 都 不 在@@ 家 ， ”
i could be parking right in front of my building . &quot;	“ 我 要是 回去 就 能 把 车 停@@ 到 我 自己 的 门@@ 前 了 。 ”
and he sp@@ ends two weeks n@@ ag@@ ged by the idea that he is missing the opportunity , day after day , to have a great parking space .	结果 整整 两个 星期 他 都 被 这么 个 想法 折磨 着 ， 天@@ 天 都 在 念@@ 叨 失去 了 占 到 那个 好 停车@@ 位 的 机会 。
opportunity costs sub@@ tract from the satis@@ fac@@ tion we get out of what we choose , even when what we choose is terri@@ fic .	“ 机@@ 会@@ 成本 ” 总是 让 我们 对 已经 做出 的 决定 不够 满意 哪怕 这个 决定 实际上 很 英@@ 明 。
and the more options there are to consider , the more attrac@@ tive features of these options are going to be reflec@@ ted by us as opportunity costs .	我们 面临 的 选@@ 项 越 多 这些 选@@ 项 里 吸引 人 的 东西 也 就 越 多 ， 这些 东西 最后 都 成 了 机@@ 会@@ 成本 。
here &apos;s another example .	这 又 是 一个 例子 。
now this cartoon makes a lot of points .	这 幅 漫画 说明 了 好@@ 几个 问题 。
it makes points about living in the moment as well , and probably about doing things slowly .	它 也 说出 了 “ 活@@ 在 当下 ” 这个 道理 。 也许 还 包括 做 事情 要 一步 一步 来 。
but one point it makes is that whenever you &apos;re cho@@ o@@ sing one thing , you &apos;re cho@@ o@@ sing not to do other things .	但是 ， 其中 一条 道理 就是 ， 当 你 选择 了 做 某@@ 件事 ， 你 同时 就 选择 了 不 做 其它 的 事 。
and those other things may have lots of attrac@@ tive features , and it &apos;s going to make what you &apos;re doing less attrac@@ tive .	这些 其它 的 事 往往 会 有 很多 吸引 你 的 地方 ， 并且 会 削@@ 弱 你 正在 做 的 事 对 你 的 吸@@ 引力 。
third : es@@ cal@@ ation of expectations .	第三@@ 点 ， 期@@ 望@@ 值 增@@ 高 。
this hit me when i went to replace my je@@ ans .	这点 在 有 一次 我 去 买 一条 新 牛@@ 仔@@ 裤 时 对 我 触@@ 动 很大 。
i wear je@@ ans almost all the time .	我 差不多 总是 穿 牛@@ 仔@@ 裤 。
and there was a time when je@@ ans came in one fla@@ vor , and you bought them , and they fit like cra@@ p , and they were incredibly un@@ comfortable , and if you wor@@ e them long enough and wa@@ shed them enough times , they started to feel ok .	过去 ， 牛@@ 仔@@ 裤 就 那 一种 样@@ 式 ， 你 买@@ 回来 ， 裤@@ 子 不 合适 ， 糟@@ 糕@@ 透@@ 顶 ， 而且 非常 不 舒服 ， 直到 你 把 它 穿 得 时间 足够 长 ， 洗 了 无@@ 数@@ 次 以后 ， 裤@@ 子 才 变得 凑@@ 合 。
so i went to replace my je@@ ans after years and years of wearing these old ones , and i said , you know , &quot; i want a pair of je@@ ans . here &apos;s my size . &quot;	就 这么 ， 穿 了 这 许@@ 多年 的 旧 裤@@ 子 ， 我 终于 上@@ 街 去 要 买@@ 条 新 的 了 。 我 说 ： “ 喂 ， 我 想要 一条 牛@@ 仔@@ 裤 ， 这 是 我 的 尺寸 。 ”
and the shop@@ kee@@ per said , &quot; do you want sli@@ m fit , easy fit , rela@@ xed fit ?	店@@ 员 说 ： 你 要@@ 紧 身@@ 型 的 ， 舒@@ 适@@ 型 的 ， 还是 宽@@ 松 型 的 ？
you want button fly or zi@@ pper fly ? you want st@@ one@@ wa@@ shed or aci@@ d-@@ wa@@ shed ?	前面 要 扣@@ 子 的 还是 拉@@ 锁 的 ？ 石@@ 磨 的 还是 酸@@ 洗 的 ？
do you want them di@@ stre@@ ssed ?	要 那种 快 磨@@ 破 的 么 ？
you want bo@@ ot cut , you want ta@@ per@@ ed , bla@@ h bla@@ h bla@@ h ... &quot; on and on he went .	直@@ 口 的 ， 还是 缩@@ 口 的 ？ 他 喋@@ 喋@@ 不@@ 休 地@@ 问 着 。
my ja@@ w dropped , and after i reco@@ vered , i said , &quot; i want the kind that used to be the only kind . &quot;	我 的 下@@ 巴 差@@ 点 掉@@ 下来 。 等 我 缓@@ 过 神@@ 来 ， 我 问 ， “ 我要 的 是 那种 曾经 是 唯一 一种 的 样@@ 式 。 ”
he had no idea what that was , so i spent an hour trying on all these dam@@ n je@@ ans , and i walked out of the store -- truth ! -- with the be@@ st-@@ f@@ itting je@@ ans i had ever had .	他 一@@ 头@@ 雾@@ 水 ， 结果 我花 了 一个 钟@@ 头 试@@ 穿 了 所有 这些 该@@ 死 的 牛@@ 仔@@ 裤 ， 最后 ， 说@@ 实@@ 话 ， 我 带 着 一条 我 从@@ 未@@ 有过 的 最 合@@ 身 的 裤@@ 子 走出 店@@ 门 。
i did better . all this choice made it possible for me to do better .	我 做 得 的确 不错 。 这些 选择 使得 我 有 机会 做 的 更好 。
but i felt worse .	但是 心里 感觉 却 更@@ 糟 。
why ? i wrote a whole book to try to explain this to myself .	为什么 ？ 为 这 我 还 专门 写 了 一 本书 来 为 我 自己 找 借@@ 口 。
the reason i felt worse is that , with all of these options available , my expectations about how good a pair of je@@ ans should be went up .	让 我 感觉 更 糟糕 的 理由 就是 ， 由于 有 了 这么 多 的 可@@ 选@@ 性 ， 我 对于 一条 牛@@ 仔@@ 裤 到底 该 有 多 好 才 算 好 的 期@@ 望@@ 值 大@@ 大 升@@ 高 。
i had very low -- i had no particular expectations when they only came in one fla@@ vor .	我 以前 期@@ 望@@ 值 很 低 。 当 牛@@ 仔@@ 裤 就 那么 一种 时 ， 我 没有 过@@ 多 指@@ 望 。
when they came in 100 fla@@ v@@ ors , dam@@ n it , one of them should &apos;ve been perfect .	当 它们 有 一百@@ 种 规@@ 格 时 ， 哼 ， 最好 至少 有 一条 是 极@@ 致 完美 的 。
and what i got was good , but it wasn &apos;t perfect .	我 那条 的确 不错 ， 但是 它 还是 不够 完美 。
and so i compared what i got to what i expected , and what i got was disa@@ p@@ poin@@ ting in compar@@ ison to what i expected .	所以 我 拿 我 已有 的 去 和 我 期望 的 进行 比较 ， 和 我 期望 的 比 起来 ， 我 这条 就 变得 令人 失望 了 。
ad@@ ding options to people &apos;s lives can &apos;t help but increase the expectations people have about how good those options will be .	在 人们 的 生活 里 加@@ 进 选择 ， 除了 提高 人们 对 事情 到底 能 有 多 好 的 期@@ 望@@ 值 以外 并 没有 给 人们 带来 多少 好处 。
and what that &apos;s going to produce is less satis@@ fac@@ tion with results , even when they &apos;re good results .	带来 的 只是 使 人们 对 结果 不 那么 满意 了 ， 即使 那 是 好 结果 。
nobody in the world of marketing knows this , because if they did , you wouldn &apos;t all know what this was about .	搞 市场 的 人 没有 人 懂得 这个 道理 。 因为 如果 他们 里面 有人 懂 的话 ， 你 也 就 不会 有 机会 知道 这是 什么 意思 了 。 （ 指 漫画 ）
the truth is more like this .	事实 很 像 这个 （ 漫画 文 ： 在 所有 东西 都 很 糟糕 的 过去 一切 都 比 现在 更好 。 ）
the reason that everything was better back when everything was worse is that when everything was worse , it was actually possible for people to have experiences that were a pleas@@ ant surprise .	原因 在于 当 一般 的 东西 都 不@@ 怎么 好@@ 时 人们 有 可能 体验 到 某些 惊喜 。
now@@ ad@@ a@@ ys , the world we live in -- we aff@@ lu@@ ent , industri@@ alized citizens , with perfe@@ ction the expec@@ tation -- the best you can ever hope for is that stuff is as good as you expect it to be .	如今 ， 在 我们 这些 富裕 的 ， 工业@@ 化 的 市@@ 民 生活 的 世界 里 ， 尽@@ 善@@ 尽@@ 美 已 是 理所@@ 当然 的 ， 对于 每@@ 一件 东西 你 最 多 也 只能 希望 它 不 比 你 预期 的 差 。
you will never be pleas@@ antly surprised because your expectations , my expectations , have gone through the roof .	你 再@@ 也@@ 不会 被 什么 所 惊喜 ， 因为 你 我 的 期@@ 望@@ 值 比@@ 天 还 高 。
the secret to happiness -- this is what you all came for -- the secret to happiness is low expectations .	什么 是 幸福 的 秘密 ， 这是 你们 今天 来 这里 想要 知道 的 ， 幸福 的 秘密 就是 ： 知@@ 足@@ 常@@ 乐 ， 不要 期望 过@@ 高 。
i want to say -- just a little au@@ to@@ bio@@ graphi@@ cal moment -- that i actually am married to a wife , and she &apos;s really quite wonderful .	（ 掌声 ） 我 想 抽 一点 时间 说 说 自己 ， 我 娶 了 我 现在 的 太@@ 太 ， 她 是 一个 很 好 的 妻子
i couldn &apos;t have done better . i didn &apos;t set@@ tle .	这件 事@@ 上 我 没有 凑@@ 合 ， 我 尽@@ 力 了 。
but sett@@ ling isn &apos;t always such a bad thing .	但是 能 凑@@ 合 并不@@ 一定 是 坏@@ 事 。
finally , one con@@ sequence of buying a bad@@ -@@ f@@ itting pair of je@@ ans when there is only one kind to buy is that when you are dis@@ satis@@ fied , and you ask why , who &apos;s responsible , the answer is clear : the world is responsible . what could you do ?	最后 ， 买 一条 不@@ 合@@ 身 的 牛@@ 仔@@ 裤 的 结果 之一 就是 ， 当 商店 里 只有 一种 样@@ 式 可以 买@@ 到 时 ， 你 觉得 不 满意 ， 想 知道 为什么 ， 这 责任 归 谁 ？ 答案 很 明显 。 这个 世界 该 为此 负责 。 你 有 什么 能 做 的 么 ？
when there are hundreds of different sty@@ les of je@@ ans available , and you buy one that is disa@@ p@@ poin@@ ting , and you ask why , who &apos;s responsible ?	现@@ 如今 店@@ 里 有 上 百@@ 种 牛@@ 仔@@ 裤 供 你 选择 ， 你 买 了 一条 回来 ， 觉得 不 满意 ， 这@@ 时候 你 问 为什么 ， 谁 的 责任 ？
it is equally clear that the answer to the question is you .	现在 这个 问题 的 答案 显然 就是 ： 你 。
you could have done better .	你 完全 可以 做 得 更好 。
with a hundred different kinds of je@@ ans on display , there is no exc@@ use for failure .	那里 摆@@ 着 上 百@@ 种 牛@@ 仔@@ 裤 ， 你 没有 借@@ 口 把 事情 搞@@ 砸 。
and so when people make decisions , and even though the results of the decisions are good , they feel disa@@ p@@ pointed about them ; they bla@@ me themselves .	结果 是 ， 当 人们 做出 决定 时 即使 那个 决定 达到 的 结果 很 好 他们 还是 （ 对 决定 ） 感到 失望 ， 要 责@@ 备 自己 。
clinical depression has explo@@ ded in the industrial world in the last generation .	在 我们 过去 的 这 一@@ 代人 里 ， 工业@@ 化 世界 （ 发达国家 ） 中 临床 压@@ 抑 症 爆@@ 炸@@ 性 增长 。
i believe a significant -- not the only , but a significant -- contribu@@ tor to this explo@@ sion of depression , and also suicide , is that people have experiences that are disa@@ p@@ poin@@ ting because their standards are so high , and then when they have to explain these experiences to themselves , they think they &apos;re at fa@@ ult .	我 相信 造成 这种 爆@@ 炸@@ 性 增长 的 压@@ 抑 和 自杀 的 一个 重要 的 ， 不是 唯一 的 ， 但是 是 重要 的 因素 就是 人们 所有 的 那些 的 令人 失望 的 经历 。 原因 就是 他们 的 标准 太@@ 高 。 当 他们 必须 去 解释 这些 经历 到底 是 怎么回事 时 ， 他们 认为 这是 他们 自己 的 过@@ 错 。
and so the net result is that we do better in general , objec@@ tively , and we feel worse .	最后 的 净 效果 就是 ， 尽管 客@@ 观 上 我们 做 得 比 以往 好 了 ， 但是 感觉 上 却 不如 从前 。
so let me remind you .	我 再 提醒 大家 ，
this is the official do@@ g@@ ma , the one that we all take to be true , and it &apos;s all false . it is not true .	这个 （ 选择 带来 幸福 ） 的 公@@ 认 的 信@@ 条 ， 我们 都 觉得 是 对 的 ， 其实 是 错 的 。 完全 不 对 。
there &apos;s no question that some choice is better than none , but it doesn &apos;t follow from that that more choice is better than some choice .	毫无疑问 有 选择 比 没 选择 要 好 ， 但是 不能 就@@ 此 推@@ 论 选择 越@@ 多@@ 越@@ 好 。
there &apos;s some ma@@ gical amount . i don &apos;t know what it is .	这里 有 一个 关键 值 ， 我 不 知道 是 多少 。
i &apos;m pretty confi@@ dent that we have long since passed the point where options improve our wel@@ f@@ are .	但是 我 可以 肯定 我们 早@@ 就 远远 超@@ 出 了 ‘ 选择 令 我们 富有 ' 所 需要 的 这个 关键 值 了 。
now , as a policy matter -- i &apos;m almost done -- as a policy matter , the thing to think about is this : what en@@ ables all of this choice in industrial societies is material aff@@ lu@@ ence .	我@@ 快 说@@ 完 了 。 现在 说 说 一个 政策 问题 ， 我们 该 想想 的 一个 政策 问题 是 ， 给 我们 这个 工业@@ 化 社会 带来 这么 多 选择 的 ， 是 物质 的 极@@ 大@@ 丰富 。
there are lots of places in the world , and we have heard about several of them , where their problem is not that they have too much choice .	我们 这个 世界 上 还有 很多 地方 ， 至少 我们 听说 过 其中 几个 ， 在 那里 问题 不是 选择 太 多 ，
their problem is that they have too little .	而是 几乎 没有 。
so the stuff i &apos;m talking about is the pe@@ cu@@ liar problem of modern , aff@@ lu@@ ent , western societies .	所以 我 在 这里 谈 的 这个 话题 是 现代 富裕 的 西方 社会 的 一个 特殊 问题 。
and what is so frustr@@ ating and in@@ fu@@ ri@@ ating is this : steve lev@@ it@@ t talked to you yesterday about how these expensive and diffic@@ ul@@ t-@@ to-@@ inst@@ all child seats don &apos;t help . it &apos;s a waste of money .	史蒂夫 。 里@@ 维@@ 特 昨天 就 说 过 ， 令人@@ 气@@ 愤 的 问题 是 ， 我们 生产 的 那些 昂贵 而 又 难以 操作 的 婴儿 汽车@@ 座椅 于@@ 事@@ 无@@ 补 ， 只是 在 浪费 钱 。
what i &apos;m telling you is that these expensive , complicated choices -- it &apos;s not simply that they don &apos;t help .	而 我 今天 要说 的 就是 这些 昂贵 的 ， 复杂 的 选择 不仅仅 是 于@@ 事@@ 无@@ 补 ，
they actually hurt .	它们 其实 在 给 我们 带来 伤害 。
they actually make us worse off .	它们 其实 让 我们 变得 不如 从前 。
if some of what en@@ ables people in our societies to make all of the choices we make were shi@@ fted to societies in which people have too few options , not only would those people &apos;s lives be impro@@ ved , but ours would be impro@@ ved also .	如果 我们 把 给 这个 社会 创造 出 这些 选择 的 人@@ 力@@ 物@@ 力 拿出 一部分 来 投入 到 那些 现在 人们 还 没有 足够 选择 的 社会 中 去 ， 那么 不仅 那里 人们 的 生活 可以 得到 改善 ， 我们 自己 的 生活 质量 也 同样 得到 提高 。
this is what economists call a &quot; par@@ e@@ to-@@ impro@@ ving move . &quot;	这 就是 经济学家 称之为 的 帕@@ 累@@ 托 改善 的 做法 。
income re@@ distribution will make everyone better off -- not just poor people -- because of how all this ex@@ cess choice pla@@ gu@@ es us .	产品 的 再 分配 会 使得 所有人 ， 不仅仅 是 穷人 ， 的 生活 好 起来 ， 因为 我们 摆脱 了 那些 像 瘟@@ 疫 般 困扰 我们 的 多@@ 余 的 选择
so to conclu@@ de . you &apos;re supposed to read this cartoon , and , being a sophisticated person , say , &quot; ah ! what does this fish know ?	结束 之前 ， 你们 该 看看 这 幅 漫画 ， 并 站 在 一个 智@@ 者 的 立@@ 场 说 ， “ 哼 ， 这条 鱼 懂 什么 ？
you know , nothing is possible in this fi@@ sh@@ bo@@ wl . &quot;	告诉 你 ， 在 这个 鱼@@ 缸 里 一切都是 不 可能 的 。 ”
im@@ pover@@ ished imagination , a m@@ yo@@ pi@@ c view of the world -- and that &apos;s the way i read it at first .	毫无 想象力 ， 目@@ 光@@ 短@@ 浅 - 我 第一次 看到 这幅 画@@ 时 是 这么 解读 的 。
the more i thought about it , however , the more i came to the view that this fish knows something .	可是 ， 我 越 想 越 明显 地 感到 这@@ 鱼 肯定 知道 些 什么 。
because the truth of the matter is that if you sha@@ tter the fi@@ sh@@ bo@@ wl so that everything is possible , you don &apos;t have freedom . you have paraly@@ sis .	因为 说@@ 实@@ 话 如果 你 想 让 一切 都 变得 有 可能 而 把 鱼@@ 缸 打破 ， 你 得到 的 不是 自由 ， 而是 瘫痪 （ 鱼@@ 会 死 ） 。
if you sha@@ tter this fi@@ sh@@ bo@@ wl so that everything is possible , you decre@@ ase satis@@ fac@@ tion .	如果 你 想 让 一切 都 变得 有 可能 而 把 鱼@@ 缸 打破 ， 你 反而 降低 了 满@@ 意@@ 度 。
you increase paraly@@ sis , and you decre@@ ase satis@@ fac@@ tion .	你 增加 了 的 是 瘫痪 ， 减少 了 的 是 满足 。
everybody needs a fi@@ sh@@ bo@@ wl .	每个 人 都 需要 这么 个 “ 鱼@@ 缸 ” 。
this one is almost certainly too limited -- perhaps even for the fish , certainly for us .	至于 这个 （ 鱼@@ 缸 ） 嘛 ， 对 这条 鱼 可能 是 小 了 点 ， 对于 我们 几乎 肯定 是 太@@ 小 了 。
but the ab@@ s@@ ence of some metaph@@ ori@@ cal fi@@ sh@@ bo@@ wl is a reci@@ pe for miser@@ y , and , i su@@ spect , disaster .	但是 ， 没有 这么 个 象@@ 征@@ 性 的 鱼@@ 缸 那 就 意味着 苦@@ 难 将 至 ， 也许 是 ， 灾难 。
thank you very much .	非常感谢 。
you know , i &apos;ve talked about some of these projects before -- about the human genome and what that might mean , and disco@@ vering new sets of genes .	在 这 之前 我 已经 讨论 过 这些 项目 中 的 一部分 关于 人类 基因组 和 它们 的 意义 。 以及 发现 新 的 基因组 。
we &apos;re actually starting at a new point : we &apos;ve been di@@ gi@@ ti@@ zing biology , and now we &apos;re trying to go from that digital code into a new phase of biology with designing and syn@@ the@@ si@@ zing life .	这次 我们 要 从 一个 新 的 角度 来看 ： 我们 在 从事 数@@ 字@@ 化 生物学 的 工作 。 并且 现在 我们 正 尝试 从 那些 数字 代码 走向 一个 生物学 的 全新 阶段 , 设计 与 人工@@ 合成 生命 。
so , we &apos;ve always been trying to ask big questions .	我们 经常 试图 提出 一些 较@@ 大 的 问题 。
&quot; what is life ? &quot; is something that i think many bio@@ logists have been trying to understand at various levels .	“ 生命 是 什么 ” 我 想 是 许多 生物学家 不断 地 尝试 在 在 不同 层面 去 理解 的 问题 。
we &apos;ve tried various appro@@ aches , par@@ ing it down to min@@ ima@@ l components .	我们 尝试 了 许多 方法 ， 把 它 分解 到 最@@ 小 的 组@@ 成@@ 部分 。
we &apos;ve been di@@ gi@@ ti@@ zing it now for almost 20 years ; when we sequ@@ enced the human genome , it was going from the analo@@ g world of biology into the digital world of the computer .	到 目前 我们 几乎 已经 用 了 20 年 来 将 其 数@@ 字@@ 化 。 当 我们 在 排@@ 序 人类 基因组 的 时候 ， 它 从 生物学 的 模拟 分析 世界 走进 了 计算机 的 数字 世界 。
now we &apos;re trying to ask , &quot; can we re@@ generate life or can we create new life out of this digital universe ? &quot;	现在 我们 在 尝试 提@@ 问 ， 我们 是否 能够 再@@ 造 生命 ， 或者 我们 是否 从 这个 数字 世界 中 能 创造 新 的 生命 ?
this is the map of a small organism , my@@ cop@@ la@@ sm@@ a gen@@ it@@ ali@@ um , that has the sm@@ alle@@ st genome for a species that can self-@@ repli@@ cate in the laboratory , and we &apos;ve been trying to just see if we can come up with an even smaller genome .	这是 一种 微生物 的 基因 序@@ 列@@ 图 , 生@@ 殖 支@@ 原@@ 体 , 它 有着 对于 一个 物种 来说 最@@ 小 的 基因组 能 使 其 在 实验室 中 自我 复制 。 并且 我们 在 尝试 了解 是否 我们 能 找到 一种 更 小 的 基因组 。
we &apos;re able to kno@@ ck out on the order of 100 genes out of the 500 or so that are here .	我们 能够 从 500 组 基因 中 分离 出 一@@ 百 组 就是 我们 眼前 的 这些 。
when we look at its metabo@@ lic map , it &apos;s relatively simple compared to ours -- trust me , this is simple -- but when we look at all the genes that we can kno@@ ck out one at a time , it &apos;s very un@@ likely that this would yi@@ eld a living cell .	但 当 我们 来看 它 的 新@@ 陈@@ 代谢 的 时候 ， 这 其实 是 相对 简单 的 相对 我们 的 来说 。 相信 我 ， 这@@ 算 简单 的 。 但 当 我们 在 看 所有 这些 我们 能 一个 一个 分离 出 的 基因组 的 时候 ， 很难 相信 它们 能 产生 出 一个 活@@ 生@@ 生 的 细胞 。
so we decided the only way forward was to actually syn@@ the@@ size this chro@@ mo@@ some so we could v@@ ary the components to ask some of these most fundamental questions .	所以 ， 我们 认为 唯一 能 继续 研究 的 方法 就是 人工@@ 合成 这些 染色体 以便 我们 能 改变 它 的 组@@ 成@@ 部分 来 继续 提@@ 问 这些 最 基本 的 问题 。
and so we started down the road of : can we syn@@ the@@ size a chro@@ mo@@ some ?	于是 我们 开始 沿着 这条 路 走 下去 “ 我们 能 人工@@ 合成 染色体 吗 ？ ”
can chemistry per@@ mit making these really large molecules where we &apos;ve never been before ?	化学 原则 真的 允许 我们 制造 这些 我们 从未 实现 过 的 超@@ 大 分子 吗 ？
and if we do , can we bo@@ ot up a chro@@ mo@@ some ?	而且 ， 就算 我们 可以 ， 我们 能 激活 它 吗 ？
a chro@@ mo@@ some , by the way , is just a piece of in@@ er@@ t chemical material .	一@@ 对 染色体 ， 顺便 说 下 ， 只是 一些 无 活@@ 性 的 化学物质 。
so , our pace of di@@ gi@@ ti@@ zing life has been increasing at an expon@@ ential pace .	我们 数@@ 字@@ 化 生命 的 速度 不断 地 以 指数 速度 加@@ 快 。
our ability to write the genetic code has been moving pretty slowly but has been increasing , and our latest point would put it on , now , an expon@@ ential curve .	我们 写 基因 编码 的 能力 进步 地 却 非常 慢 ， 不过 也 还是 在 增加 的 。 我们 最近 的 状况 将会 把 速度 提升 到 指数 曲线 。
we started this over 15 years ago .	我们 于 15 年前 开始 这项 工作 。
it took several st@@ ages , in fact , starting with a bio@@ eth@@ ical re@@ view before we did the first experiments .	实际上 它 经过 了 好@@ 几个 阶段 。 在 我们 做 最初 的 试验 前 ， 先 进行 了 一次 生物 伦@@ 理@@ 学 的 评估 。
but it turns out syn@@ the@@ si@@ zing dna is very difficult .	但 结果 是 人工@@ 合成 dna 是 非常 困难 的 。
there are tens of thousands of machines around the world that make small pieces of dna -- 30 to 50 letters in length -- and it &apos;s a de@@ generate process , so the longer you make the piece , the more er@@ rors there are .	全世界 有 十@@ 几@@ 万 台 设备 在 制造 小 片@@ 断 的 dna ， 长度 在 30 到 50 个@@ 字@@ 符 ， 并且 这是 一个 会 倒@@ 退 的 过程 ， 制造 的 片@@ 断 越@@ 是 长 ， 产生 的 错误 就 越@@ 是 多 。
so we had to create a new method for putting these little pieces together and correct all the er@@ rors .	所以 我们 不得不 创造 一种 新 的 方法 把 这些 小 的 片@@ 断 排放 在 一起 并 纠@@ 正 所有 的 错误 。
and this was our first attempt , starting with the digital information of the genome of ph@@ i x@@ 17@@ 4 .	这是 我们 的 第一次 尝试 ， 从 ph@@ i x 17@@ 4 基因组 （ 噬@@ 菌@@ 体 ） 的 数@@ 字@@ 信息 开始 。
it &apos;s a small virus that kil@@ ls bacteria .	是 一种 能 杀死 细菌 的 小型 病毒 。
we designed the pieces , went through our error correc@@ tion and had a dna molecule of about 5,000 letters .	我们 设计 了 它 的 基因 片@@ 断 ， 经过 了 错误 纠@@ 正 ， 就 拥有 了 一条 5000 字@@ 符 长度 的 dna 。
the exciting phase came when we took this piece of in@@ er@@ t chemical and put it in the bacteria , and the bacteria started to read this genetic code , made the viral particles .	最 另 人 兴奋 的 阶段 是 当 我们 把 这段 没有 活@@ 性 的 化学物质 放进 细菌 内 ， 细菌 开始 读@@ 取 基因 编码 ， 制造 了 病毒 粒子 。
the viral particles then were released from the cells and came back and killed the e@@ . col@@ i .	接着 细胞 释放 出 病毒 粒子 ， 再 返@@ 回 来 杀死 了 e . col@@ i （ 革@@ 兰@@ 氏 阴@@ 性@@ 菌 ） 。
i was talking to the oil industry recently and i said they clearly understood that model .	我 最近 与 石油 行业 有 一些 交流 ， 我 觉得 他们 对 这个 模式 理解 的 非常 透@@ 彻 。
they laugh@@ ed more than you guys are .	他 比 你们 笑 的 大@@ 声 多 了 。
and so , we think this is a situation where the software can actually build its own hardware in a biological system .	因此 我们 认为 这种 情况 实际上 是 软件 能 在 一个 生物 系统 内 打@@ 造 自己 的 硬@@ 件 。
but we wanted to go much larger : we wanted to build the entire bacter@@ ial chro@@ mo@@ some -- it &apos;s over 5@@ 8@@ 0,000 letters of genetic code -- so we thought we &apos;d build them in ca@@ s@@ set@@ tes the size of the viruses so we could actually v@@ ary the ca@@ s@@ set@@ tes to understand what the actual components of a living cell are .	但 我们 还 想 再 扩大 规模 。 我们 希望 制造 整@@ 条 细菌 染色体 ， 一条 超过 5@@ 80 ， 000 字@@ 符 长度 的 基因 编码 。 我们 认为 应该 在 以 病毒 大小 的 “ 盒 ” 中 制造 它们 这样 我们 可以 改变 这些 “ 盒 ” 来 理解 一个 活 的 细胞 的 实际 组@@ 成@@ 部分 是 什么 ？
design is critical , and if you &apos;re starting with digital information in the computer , that digital information has to be really accurate .	设计 是 非常 重要 的 ， 并且 如果 你 在 计算机 上 开始 使用 数@@ 字@@ 信息 。 那 这些 数@@ 字@@ 信息 必须 十分 准确 。
when we first sequ@@ enced this genome in 199@@ 5 , the standard of accur@@ acy was one error per 10,000 base pa@@ irs .	当 我们 在 199@@ 5 年 第一次 对 这@@ 组 基因 排@@ 序 时 ， 准@@ 确@@ 率 的 标准 是 每 10@@ 000 个 基本 对 一个 错误 。
we actually found , on re@@ sequ@@ encing it , 30 er@@ rors ; had we used that original sequence , it never would have been able to be bo@@ ot@@ ed up .	实际上 我们 发现 ， 在 重新 排@@ 序 时 ， 平均 是 30 个 错误 。 如果 我们 使用 原@@ 先 的 序列 ， 这@@ 组 基因 永远 不 可能 被 启动 。
part of the design is designing pieces that are 50 letters long that have to over@@ la@@ p with all the other 5@@ 0-@@ letter pieces to build smaller su@@ bun@@ its we have to design so they can go together .	设计 工作 的 一部分 是 设计 50 个@@ 字@@ 符 长度 的 片@@ 断 并 和 其他 的 50 字@@ 符 长 的 片段 叠@@ 加 以 构建 更 小 的 次 单@@ 元 。 我们 要 设计 过 他们 才能 聚@@ 到 一起 。
we design unique elements into this .	其中 有 我们 设计 过 的 独特 部分 。
you may have read that we put water@@ mar@@ ks in .	你们 可能 听说 过 我们 在 其中 加入 了 水@@ 印
think of this : we have a four-@@ letter genetic code -- a , c , g and t .	想@@ 想@@ 看 基因 编码 有 四个 字@@ 符 ： a , c , g 和 t 。
tri@@ ple@@ ts of those letters code for roughly 20 am@@ ino ac@@ ids , such that there &apos;s a single letter desig@@ nation for each of the am@@ ino ac@@ ids .	这些 字@@ 符 的 三@@ 联@@ 体 - 以及 这些 字@@ 符 编@@ 成 了 大约 20 种 氨@@ 基@@ 酸 这样 每个 氨@@ 基@@ 酸 就 有 了 一个 字@@ 符 标记
so we can use the genetic code to write out words , sent@@ ences , thoughts .	所以 我们 能 使用 基因 编码 来 书@@ 写 言@@ 语 句子 ， 想法 。
initi@@ ally , all we did was au@@ to@@ graph it .	最初 ， 我们 所 做 的 就是 用 它 来 签@@ 名 。
some people were disa@@ p@@ pointed there was not poetry .	有些 人 有点 失望 我们 没@@ 用 它 来 做 首@@ 诗 。
we designed these pieces so we can just che@@ w back with en@@ z@@ y@@ mes ; there are en@@ z@@ y@@ mes that repair them and put them together .	我们 设计 了 这些 片@@ 断 并 能 使用 酶 来 裁@@ 切 。 有些 酶 是 用来 修复 他们 并 把 他们 放到 一起 的 。
and we started making pieces , starting with pieces that were 5,000 to 7@@ ,000 letters , put those together to make 24@@ ,@@ 00@@ 0-@@ letter pieces , then put sets of those going up to 7@@ 2,000 .	接着 我们 开始 制造 片@@ 断 ， 从 7@@ 000 字@@ 符 长度 的 片@@ 断 开始 把 他们 拼@@ 在一起 制造 24 ， 000 字@@ 符 长度 的 片@@ 断 再 把 几@@ 组 片@@ 断 合@@ 并 ， 变成 了 72 ， 000 长 的 片@@ 断
at each stage , we grew up these pieces in abun@@ dance so we could sequence them because we &apos;re trying to create a process that &apos;s extremely ro@@ bust that you can see in a minute .	在 每个 阶段 ， 我们 大量 培养 了 这些 片@@ 断 因此 我们 可以 给 他们 排@@ 序 因为 我们 希望 创造 一个 异常 可靠 的 过程 一分钟 内 你 就 将 看见
we &apos;re trying to get to the point of autom@@ ation .	我们 试着 达到 自@@ 动@@ 化 的 层面
so , this looks like a bas@@ ke@@ t@@ ball pla@@ yo@@ ff .	这 看起来 就 像是 一场 篮@@ 球@@ 赛 的 对@@ 阵 图
when we get into these really large pieces over 100,000 base pa@@ irs , they won &apos;t any longer grow re@@ adi@@ ly in e@@ . col@@ i -- it ex@@ ha@@ u@@ sts all the modern tools of molecular biology -- and so we turned to other mechan@@ isms .	当 这些 非常 大 的 片@@ 断 超过 100 ， 000 基本 对@@ 时 他们 就 很 难 继续 在 e . co@@ il 里@@ 长 的 更@@ 长 了 。 在 试@@ 尽 了 各种 现代 分@@ 子@@ 生物学 的 工具 后 我们 转向 其他 的 途径 。
we knew there &apos;s a mechanism called hom@@ o@@ log@@ ous re@@ combination that biology uses to repair dna that can put pieces together .	我们 知道 有个 方法 叫 同@@ 源 重@@ 组 ， 生物学 上 用来 修复 dna ， 它 能 把 片@@ 断 组合 到 一起
here &apos;s an example of it : there &apos;s an organism called de@@ in@@ o@@ co@@ c@@ c@@ us radi@@ od@@ ur@@ ans that can take three millions ra@@ ds of radiation .	这里 有 一个 例子 有 一种 微生物 叫 耐 辐射 球@@ 菌 能够 承受 三@@ 百万 度 的 辐@@ 射@@ 量 。
you can see in the top pan@@ el , its chro@@ mo@@ some just gets blo@@ wn apart .	你 能 看到 在 顶@@ 部 的 视@@ 图 里 ， 它 的 染色体 四@@ 散 在 各个 地方
tw@@ el@@ ve to 24 hours later , it put it back together exactly as it was before .	12 到 24 小时 以后 ， 它 将 自己 又 组合 回 之前 的 原@@ 状 。
we have thousands of organisms that can do this .	我们 有 数@@ 千@@ 种 微生物 有 这种 能@@ 耐
these organisms can be totally de@@ sic@@ cated ; they can live in a vac@@ u@@ um .	这些 微生物 能够 完全 脱离 水 。 他们 能 存活 在 真@@ 空 中
i am absolutely certain that life can exist in ou@@ ter space , move around , find a new a@@ que@@ ous environment .	我 完全 确信 外@@ 层@@ 空间 存在 着 生命 ， 四处 移动 ， 遇到 一个 新 的 有 水 的 环境
in fact , nasa has shown a lot of this is out there .	实际上 ， nasa 已经 展示 过 很多 这样 的 例子 。
here &apos;s an actual micro@@ graph of the molecule we built using these processes , actually just using yea@@ st mechan@@ isms with the right design of the pieces we put them in ; yea@@ st puts them together automatically .	这里 有 一组 我们 拍摄 的 这个 分子 的 显@@ 微 图像 。 通过 这些 过程 ， 其实 就是 前面 所 提到 的 酵@@ 母 的 方法 同时 放入 经过 我们 正确 设计 的 片@@ 断 。 酵@@ 母 自动 地 将 他们 聚@@ 合 。
this is not an electr@@ on micro@@ graph ; this is just a regular phot@@ om@@ ic@@ ro@@ graph .	这 并 不是 电子@@ 显@@ 微 图像 ； 它 仅仅 是 普通 的 光@@ 学 显微镜 。
it &apos;s such a large molecule we can see it with a light microscope .	这是 如此 之@@ 大 的 一个 分子 我们 能 用 一个 光@@ 学 显微镜 观察 它 。
these are pictures over about a six@@ -@@ second period .	这些 是 时@@ 长 约 为 六@@ 秒 的 图像 。
so , this is the publi@@ cation we had just a short while ago .	这是 我们 所 公开 的 最近 的 试验 成果 。
this is over 5@@ 8@@ 0,000 letters of genetic code ; it &apos;s the largest molecule ever made by humans of a defined structure .	这是 超过 5@@ 8@@ 0@@ 000 字@@ 符 长 的 基因 编码 。 这 也 是 由 人类 设@@ 定 结构 并 制造 的 最大 的 分子 。
it &apos;s over 300 million molecular weight .	它 超过 了 3 亿 分子 重量 。
if we prin@@ ted it out at a 10 f@@ on@@ t with no spac@@ ing , it takes 14@@ 2 pages just to print this genetic code .	如果 我们 以 10 号 字@@ 体 不 间@@ 隔 地 将 其 打印 出来 。 总@@ 共 需要 14@@ 2 页 来 打印 这些 基因 编码
well , how do we bo@@ ot up a chro@@ mo@@ some ? how do we activ@@ ate this ?	那 我们 该 如何 来 启动 一段 染色体 ， 我们 该 如何 激活 它 ?
obviously , with a virus it &apos;s pretty simple ; it &apos;s much more complicated dealing with bacteria .	显然 处理 一个 病毒 非常简单 处理 一个 细菌 就 复杂 多 了
it &apos;s also sim@@ pl@@ er when you go into eu@@ kar@@ yo@@ tes like ourselves : you can just pop out the nuc@@ le@@ us and pop in another one , and that &apos;s what you &apos;ve all heard about with c@@ lon@@ ing .	处理 像 我们 自身 这样 的 真@@ 核 生物 也 相对 简单 你 能 取出 一个 细@@ 胞@@ 核 然后 塞@@ 进 另 一个 细胞 中 ， 这 就是 大家 听到 的 关于 克@@ 隆 的 手@@ 法
with bacteria and ar@@ cha@@ e@@ a , the chro@@ mo@@ some is integrated into the cell , but we recently showed that we can do a complete trans@@ plant of a chro@@ mo@@ some from one cell to another and activ@@ ate it .	对于 古@@ 细菌 ， 它们 的 染色体 与 整个 细胞 连@@ 成 一@@ 体 ， 但 最近 我们 也 明确 了 我们 能 完成 一个 完整 的 移植 将 染色体 从 一个 细胞 转移 到 另 一个 细胞 中 并 激活 它 。
we pu@@ ri@@ fied a chro@@ mo@@ some from one micro@@ bi@@ al species -- roughly , these two are as distant as human and mice -- we added a few extra genes so we could selec@@ t for this chro@@ mo@@ some , we di@@ ge@@ sted it with en@@ z@@ y@@ mes to kill all the proteins , and it was pretty stun@@ ning when we put this in the cell -- and you &apos;ll appreciate our very sophisticated graphics here .	我们 从 一个 种@@ 群 的 微生物 中 提取 出 染色体 。 基本上 ， 这 两个 的 差别 就 如同 人类 和 老鼠 般 。 我们 加上 了 一些 新 的 基因 这样 我们 就 能 选择 这些 染色体 。 我们 用 酶 来 分解 它们 去@@ 除 所有 的 蛋白质 当 我们 将 它 放入 细胞 时 发生 的 情形 非常 惊人 你们 应该 会 喜欢 我们 所 制作 的 非常 精@@ 密 的 演示 图像 --
the new chro@@ mo@@ some went into the cell .	新 的 染色体 进入 细胞 。
in fact , we thought this might be as far as it went , but we tried to design the process a little bit further .	实际上 我们 原@@ 以为 这个 过程 就 到@@ 此@@ 为止 了 。 但是 我们 试图 将 这个 过程 设计 得 更 深入 一些 。
this is a major mechanism of evolution right here .	这是 一个 重大 的 进化 机制 。
we find all kinds of species that have taken up a second chro@@ mo@@ some or a third one from somewhere , ad@@ ding thousands of new tra@@ its in a second to that species .	我们 发现 所有 接受 了 第二@@ 段 染色体 的 物种 或 来自 其他 地方 的 第三@@ 方 染色体 ， 在 一@@ 秒钟 内 增加 了 数@@ 千@@ 种 新 特征 到 其 自身 。
so , people who think of evolution as just one gene changing at a time have missed much of biology .	原本 人们 所 持@@ 有 的 在 进化 的 过程 中 每次 只会 有 一个 基因 发生@@ 变化 的 观念 忽略 了 生物 的 许多 实际 情况 。
there are en@@ z@@ y@@ mes called restri@@ ction en@@ z@@ y@@ mes that actually di@@ gest dna .	有 一种 酶 叫做 限制 酶 是 能够 消@@ 化 dna 的
the chro@@ mo@@ some that was in the cell doesn &apos;t have one ; the chro@@ mo@@ some we put in does .	原@@ 先 细胞 中 的 染色体 没有 这种 酶 没有 这种 酶 而 当 我们 置@@ 入 一段 拥有 这种 酶 的 染色体
it got ex@@ pressed and it recognized the other chro@@ mo@@ some as foreign material , che@@ wed it up , and so we ended up just with a cell with the new chro@@ mo@@ some .	它 表现 了 出来 ， 并且 辨@@ 认@@ 出 另 一段 染色体 是 外@@ 来 物质 ， 它 就 将 其 消@@ 化 ， 最后 我们 就 有 了 一个 包含 有 新 的 dna 的 细胞
it turned blue because of the genes we put in it .	我们 放入 的 基因 导致 它 变成 了 蓝色 。
and with a very short period of time , all the character@@ is@@ tics of one species were lost and it conver@@ ted totally into the new species based on the new software that we put in the cell .	在 非常 短 的 一段时间 里 ， 所有 的 原@@ 先 物种 的 特征 全部 消失 了 ， 并且 完全 转@@ 化@@ 成 了 一个 新 物种 ， 基于 我们 放入 细胞 的 新 “ 软件 ” 。
all the proteins changed , the me@@ mb@@ ran@@ es changed ; when we read the genetic code , it &apos;s exactly what we had trans@@ fer@@ red in .	所有 的 蛋白质 都 改变 了 ， 细@@ 胞@@ 膜 也 改变 了 -- 当 我们 读@@ 取 它 的 基因 编码 ， 实际上 就是 我们 植入 的 那种 。
so , this may sound like genom@@ ic al@@ che@@ my , but we can , by moving the software of dna around , change things quite dra@@ matically .	这 可能 听 起来 像 基因 炼@@ 金@@ 术 ， 但 我们 的确 能 通过 转移 dna ， 来 急@@ 剧 地 改变 事物 。
now i &apos;ve argu@@ ed , this is not gen@@ es@@ is ; this is building on three and a half billion years of evolution .	现在 ， 我要 声@@ 明 这 不是 创@@ 世纪 -- 这是 建立 在 35 亿年 的 进化 上 的
and i &apos;ve argu@@ ed that we &apos;re about to perhaps create a new version of the ca@@ mb@@ ri@@ an explo@@ sion , where there &apos;s massive new speci@@ ation based on this digital design .	并且 我 认为 我们 可能 会 创造 新@@ 一@@ 版 的 寒@@ 武@@ 纪 生命 大 爆发 出现 大量 基于 这种 数@@ 字@@ 化 设计 的 新 物种
why do this ?	为什么 要 这样 做 ？
i think this is pretty obvious in terms of some of the needs .	我 认为 出于 一些 需求 我们 这样 做 的 原因 是 非常@@ 明显 的 。
we &apos;re about to go from six and a half to nine billion people over the next 40 years .	我们 的 人口 将 在 接下来 的 40 年 中 从 65 亿 变成 90 亿
to put it in context for myself : i was born in 194@@ 6 .	以 我 自己 的 例子 来说 我@@ 出 生@@ 于 194@@ 6 年
there are now three people on the planet for every one of us that existed in 194@@ 6 ; within 40 years , there &apos;ll be four .	现在 世界 上 就 变成 了 三个 人 相对 于 我们 中 每 一个 从 194@@ 6 年 就 存在 的 人 ； 在 接下来 的 四@@ 十年 内 ， 就 变成 了 四个 。
we have trouble feeding , providing fresh , clean water , medi@@ cines , fuel for the six and a half billion .	我们 在 为 65 亿人 提供 食物 ， 洁@@ 净 的 淡@@ 水 ， 医@@ 药 ， 燃料 上 都 十@@ 分@@ 困难 。
it &apos;s going to be a stre@@ tch to do it for nine .	换@@ 作 90 亿人 那 真是 捉@@ 襟@@ 见@@ 肘 了 。
we use over five billion tons of coal , 30 bil@@ li@@ on-@@ plus bar@@ re@@ ls of oil -- that &apos;s a hundred million bar@@ re@@ ls a day .	我们 使用 超过 50 亿@@ 顿 的 煤 ， 300 多 亿@@ 桶 的 石油 。 也 就是 每天 一@@ 千万 桶 。
when we try to think of biological processes or any process to replace that , it &apos;s going to be a huge challenge .	当 我们 尝试 思考 这个 生物 程序 或者 任何 能 替代 它 的 程序 ， 这会 是 一个 巨大 的 挑战 。
then of course , there &apos;s all that co2 from this material that ends up in the atmosphere .	接下来 ， 当然 ， 是 这份 材料 中 所 显示 的 被 排放 在 大气层 中 的 二氧化碳 。
we now , from our discovery around the world , have a datab@@ ase with about 20 million genes , and i like to think of these as the design components of the future .	我们 现在 从 全球 各地 的 发现 有 了 一个 包含 约 两@@ 千万 组 基因 的 数据库 ， 并且 我 乐@@ 于 把 它们 看作 是 未来 的 设计 组@@ 件 。
the electronics industry only had a dozen or so components , and look at the diversity that came out of that .	电@@ 气 行业 只有 十@@ 来@@ 种 组@@ 件 ， 再 看看 从中 能 得到 的 多样性 。
we &apos;re limited here pri@@ mar@@ ily by a biological reality and our imagination .	目前 我们 主要 的 限制 来自 于 生物学 的 现实@@ 情况 以及 我们 的 想@@ 像@@ 力 。
we now have techniques , because of these ra@@ pid metho@@ ds of syn@@ thesis , to do what we &apos;re calling comb@@ in@@ at@@ ori@@ al genom@@ ics .	我们 现在 拥有 这样 的 技术 ， 是因为 这些 能 制造 我们 称之为 “ 混合 染色体 组 ” 的 快速 的 人工@@ 合成 方法 。
we have the ability now to build a large robot that can make a million chro@@ mo@@ som@@ es a day .	我们 现在 所 拥有 的 制造 一个 大型 机器人 的 能力 能 让 我们 每天 制造 一百@@ 万个 染色体 。
when you think of processing these 20 million different genes or trying to optimi@@ ze processes to produce o@@ ct@@ an@@ e or to produce pharmac@@ eu@@ tic@@ als , new vac@@ cines , we can just with a small team , do more molecular biology than the last 20 years of all science .	当 你 想着 加@@ 工 这 两@@ 千万 组 不同 的 基因 ， 并 尝试 去 优@@ 化 这个 步骤 以 产生 辛@@ 烷 或者 制造 药@@ 物@@ 制@@ 剂 ， 以及 新 的 疫苗 ， 我们 就 能 改变 ， 即使 是 一个 小 团队 ， 也 能 做 比 过去 20 年 科学@@ 史 所 做 过 的 更 多 的 分@@ 子@@ 生物学 工作 。
and it &apos;s just standard selection : we can selec@@ t for vi@@ ability , chemical or fuel production , vaccine production , etc .	并且 这 只是 标准 选择 。 我们 可以 以 生@@ 存@@ 能力 来 选择 ， 化学 或 燃料 生产 ， 疫苗 生产 等等 。
this is a screen sna@@ p@@ shot of some true design software that we &apos;re working on to actually be able to sit down and design species in the computer .	这是 一张 屏幕 截@@ 图 截@@ 取 的 是 一些 我们 实际 坐下 来 工作 时 在 电脑 中 真正 用来 设计 物种 的 设计 软件 。
you know , we don &apos;t know necessarily what it &apos;ll look like : we know exactly what their genetic code looks like .	我们 并不@@ 一定 要 知道 它 看起来 是 怎样 。 我们 确@@ 切 地 知道 它们 的 基因 编码 究竟 是 什么样 的 。
we &apos;re focusing on now four@@ th-@@ generation fuels .	我们 目前 把 注意力 放在 “ 第四@@ 代 燃料 ” 上 。
you &apos;ve seen recently , corn to e@@ than@@ ol is just a bad experiment .	你们 最近 看到 了 将 谷@@ 物 转@@ 化@@ 成 乙@@ 醇 只是 一个 糟糕 的 试验 。
we have secon@@ d@@ - and thir@@ d-@@ generation fuels that will be coming out relatively soon that are sugar , to much high@@ er-@@ value fuels like o@@ ct@@ an@@ e or different types of bu@@ tan@@ ol .	很快 我们 将会 拥有 第二 及 第三@@ 代 燃料 。 就是 糖 转@@ 化@@ 成 更@@ 高 价值 的 燃料 例如 辛@@ 烷 或 不同 种类 的 丁@@ 醇 。
but the only way we think that biology can have a major impact without further increasing the cost of food and lim@@ iting its avail@@ ability is if we start with co2 as its feed@@ stock , and so we &apos;re working with designing cells to go down this road .	但 我们 认为 生物学 唯一 能 产生 一个 巨大 影响 的 同时 又 不 增加 食物 的 支@@ 出 与 限制 其 可 利用 性 的 方法 是 在于 我们 是否 能 开始 用 二氧化碳 作为 它 的 原料 。 所以 我们 正在 进行 设计 新 的 细胞 能@@ 朝 这 条@@ 路 发展 下去 。
and we think we &apos;ll have the first four@@ th-@@ generation fuels in about 18 months .	并且 我们 认为 在 18 个 月 里 我们 会 取得 第一@@ 份 第四@@ 代 燃料 。
sunlight and co2 is one method ...	阳光 和 二氧化碳 是 其中 一个 方法 --
but in our discovery around the world , we have all kinds of other metho@@ ds .	（ 掌声 ） -- 但 我们 从 全世界 各地 的 发现 中 ， 我们 还有 许@@ 多种 其他 方法 。
this is an organism we described in 199@@ 6 .	这是 一种 微生物 , 199@@ 6 年 被 记@@ 载
it lives in the deep ocean , about a mile and a half deep , almost at bo@@ il@@ ing@@ -@@ water temper@@ atures .	它 生活 在 深海 。 大约 1.@@ 5 英里 深 ， 几乎 是 在 沸@@ 腾 的 水@@ 温 中 。
it takes co2 to me@@ than@@ e using molecular hydrogen as its energy source .	它 将 二氧化碳 转@@ 化@@ 成 甲@@ 烷 使用 氢 分子 最为 它 的 能量 来源 。
we &apos;re looking to see if we can take cap@@ tured co2 , which can easily be pi@@ ped to sites , conver@@ t that co2 back into fuel to drive this process .	我们 在 看 是否 能 把 收集 到 的 二@@ 氧@@ 化 染 , ， 它们 非常 方便 就 能 被 引@@ 进 处理 站 ， 转@@ 化@@ 成 燃料 ， 来 驱动 这个 过程 。
so , in a short period of time , we think that we might be able to increase what the basic question is of &quot; what is life ? &quot;	因此 在 很 短 的 时间 内 ， 我们 觉得 我们 或许 可以 增加 对于 " 生命 是 什么 ? " 的 基本 问题 的 理解 。
we truly , you know , have mode@@ st goals of replac@@ ing the whole pe@@ tro@@ l-@@ chemical industry -- yeah . if you can &apos;t do that at ted , where can you ? -- become a major source of energy ...	我们 的确 有着 替@@ 换 整个 石@@ 油@@ 化@@ 工 行业 的 小@@ 小 目标 。 （ 掌声 ） 如果 你 不能 在 ted 做到 这些 , 哪里 还有 可能 呢 ? 成为 一项 主要 的 能源 。
but also , we &apos;re now working on using these same tools to come up with inst@@ ant sets of vac@@ cines .	并且 我们 也 在 使用 同样 的 工具 制造 了 几@@ 组 即@@ 时 疫苗 。
you &apos;ve seen this year with flu ; we &apos;re always a year behind and a dollar short when it comes to the right vaccine .	你们 都 看到 今年 出现 的 流感 ， 我们 总是 要@@ 慢 上@@ 一年 的 时间 并且 在 缺乏 资金 的 情况 下 才 等@@ 到 有用 的 疫苗 。
i think that can be changed by building comb@@ in@@ at@@ ori@@ al vac@@ cines in ad@@ v@@ ance .	我 认为 这 情形 是 可以 通过 预@@ 先 制造 混合 疫苗 来 改变 的 。
here &apos;s what the future may begin to look like with changing , now , the evolutionary tree , spe@@ eding up evolution with syn@@ thetic bacteria , ar@@ cha@@ e@@ a and , eventually , eu@@ kar@@ yo@@ tes .	这是 未来 可能 会 呈现 的 情况 伴随 着 改变 , 目前 , 进化@@ 树 随着 人造 细菌 ， 古@@ 物 种 最后 是 真@@ 核 生物 而 加速 进化
we &apos;re a ways away from impro@@ ving people : our goal is just to make sure that we have a chance to survive long enough to maybe do that . thank you very much .	我们 正在 一条 离 改善 人类 生活 越来越 远 的 路上 。 我们 的 目标 就是 确保 我们 能 有 机会 活 到 足够 长 的 时间 或许 就 能 做到 这件 事 了 。 非常感谢 大家 。
last year at ted i gave an introduc@@ tion to the l@@ h@@ c .	在 去年 的 ted 发@@ 言 上 我 介绍 了 l@@ h@@ c
and i pro@@ mis@@ ed to come back and give you an up@@ date on how that machine worked .	而且 我 说 过 一定 回来 给 大家 实@@ 况 更新 说 说 机器 的 运转 情况
so this is it . and for those of you that weren &apos;t there , the l@@ h@@ c is the largest scientific experiment ever attemp@@ ted -- 27 kilometers in circum@@ ference .	这 就是 它 ， 如果 你 去年 没 来 的话 l@@ h@@ c 是 史 上 最 大规模 的 科学@@ 实验 周@@ 长 27 公里
its job is to re@@ create the conditions that were present less than a bil@@ li@@ on@@ th of a second after the universe began , up to 600 million times a second .	用来 重@@ 塑 宇宙 形成 十@@ 亿@@ 分 之一 秒 时 的 状态 每@@ 秒 制造 6 亿@@ 次 （ 这一 状态 ）
it &apos;s nothing if not ambi@@ tious .	非常 具有 野@@ 心
this is the machine below gen@@ ev@@ a .	这 就是 在 日@@ 内@@ 瓦 地下 的 机械
we take the pictures of those mini@@ -@@ big ban@@ gs inside dete@@ ctors .	我们 用 这些 探测器 给 迷@@ 你 大 爆炸 照@@ 相
this is the one i work on . it &apos;s called the at@@ l@@ as dete@@ ctor -- 4@@ 4 meters wide , 22 meters in dia@@ meter .	这个 是 我 就@@ 职 的 那@@ 台 ， at@@ l@@ as 探测器 4@@ 4 米@@ 长 ， 直@@ 径 22 米
spect@@ acu@@ lar picture here of at@@ l@@ as under construction so you can see the scale .	这是 at@@ l@@ as 建造 过程 中 的 壮@@ 观 景象 可以 看出 规模 巨大
on the 10@@ th of september last year we turned the machine on for the first time .	去年 9 月 10 日 我们 第一次 启动 这一 机器
and this picture was taken by at@@ l@@ as .	这是 一张 at@@ l@@ as 照@@ 下 的 照片
it caused im@@ men@@ se cele@@ bra@@ tion in the control room .	当时 控制@@ 室 里 欢@@ 呼@@ 雀@@ 跃
it &apos;s a picture of the first be@@ am particle going all the way around the l@@ h@@ c , colli@@ ding with a piece of the l@@ h@@ c deli@@ ber@@ ately , and sho@@ wer@@ ing particles into the dete@@ ctor .	这是 第一 簇 粒子 的 照片 一@@ 路 沿着 l@@ h@@ c 转@@ 圈 如 我们 所 计划 地 与 l@@ h@@ c 的 一部分 相@@ 撞 大量 粒子 在 探测器 内@@ 辐@@ 散
in other words , when we saw that picture on september 10@@ th we knew the machine worked , which is a great tri@@ u@@ mp@@ h .	换句话说 ， 当 我们 在 9 月 10 号 看到 这一 景象 时 我们 知道 这 机器 起 作用 了 这 是 个 巨大 的 成功
i don &apos;t know whether this got the biggest che@@ er , or this , when someone went onto google and saw the front page was like that .	我 不 知道 是 这个 获得 了 满@@ 堂@@ 喝@@ 彩 还是 这个 — — 当 人们 登@@ 陆 谷歌 看见 首@@ 页 图@@ 标 是 这样 的 时候
it means we made cultural impact as well as scientific impact .	这 表明 我们 的 工作 造成 了 文化 冲@@ 击 这 与 它 的 科@@ 研 冲@@ 击 同样 意义 重大
about a week later we had a problem with the machine , related actually to these bits of wire here -- these gold wi@@ res .	但是 大概 一周 之后 我们 的 机器 出 了 点 故@@ 障 主要 跟 这些 导@@ 线 有关 — — 这些 金@@ 色 的 导@@ 线
those wi@@ res carry 13 thousand am@@ ps when the machine is working in full power .	这些 导@@ 线 传@@ 导 1 万 3 千 安@@ 培 电@@ 流 当 机器 全部 启动
now the engineers amongst you will look at them and say , &quot; no they don &apos;t . they &apos;re small wi@@ res . &quot;	现在 你们 之中 的 一些 工程师 可能 会 说 “ 不 可能 ， 这些 电线 太@@ 细 了 ”
they can do that because when they are very cold they are what &apos;s called super@@ conduc@@ ting wire .	它们 能 做到 因为 当 温度 极@@ 低 它们 就 成 了 超@@ 导 导@@ 线
so at min@@ us 2@@ 7@@ 1 degrees , col@@ der than the space between the stars , those wi@@ res can take that current .	所以 在 零@@ 下 2@@ 7@@ 1 摄@@ 氏@@ 度 低@@ 于 星球 间 宇宙@@ 空间 的 温度 的 情况 下 这些 导@@ 线 可以 传@@ 导 如此 强 的 电@@ 流
in one of the jo@@ ints between over 9@@ ,000 magne@@ ts in l@@ h@@ c , there was a manufacturing defe@@ ct .	在 l@@ h@@ c 中 九@@ 千@@ 多 个 电@@ 磁@@ 铁 里 的 一个 接@@ 点 上 有 一个 安装 技术 失@@ 误
so the wire he@@ ated up slightly , and its 1@@ 3,000 am@@ ps suddenly en@@ counter@@ ed electrical resistance .	于是 导@@ 线 温度 微@@ 微 升@@ 高 了 一点 导致 它 传@@ 导 的 1 万 3 千 安@@ 培 电@@ 流 忽@@ 然 受到 电@@ 阻
this was the result .	这 就是 结果
now that &apos;s more im@@ pressive when you consider those magne@@ ts we@@ i@@ gh over 20 tons , and they moved about a foot .	非常 令人@@ 震惊 因为 那些 磁@@ 铁 重@@ 达 20 吨 它们 移动 了 大约 一 英尺
so we dama@@ ged about 50 of the magne@@ ts .	一共 大概 有 50 个 磁@@ 铁 受@@ 损
we had to take them out , which we did .	必须 得 把 它们 卸@@ 下来 ， 这些 工作 已经 完成
we re@@ condi@@ tioned them all , fixed them .	我们 给 它们 排@@ 除@@ 故@@ 障 ， 修@@ 理 好
they &apos;re all on their way back under@@ ground now .	现在 就 等 着 它们 重新 回到 地下 了
by the end of march the l@@ h@@ c will be in@@ t@@ act again .	在 三@@ 月@@ 底 左右 l@@ h@@ c 被 重新 接@@ 通
we will switch it on , and we expect to take data in june or ju@@ ly , and continue with our quest to find out what the building blocks of the universe are .	我们 将会 启动 它 并且 希望 在 六@@ 七 月 的 时候 得到 数据 然后 继续 我们 的 使命 找出 宇宙 形成 的 最 基本 单位
now of course , in a way those acci@@ dents re@@ ign@@ ite the debate about the value of science and engineering at the edge . it &apos;s easy to refu@@ te .	很 明显 现在 ， 一方面 这些 事故 重新 激@@ 化 了 关于 前@@ 沿@@ 科学 和 工程@@ 学 的 辩论 ， 但 这些 很 容易 被 反@@ 驳
i think that the fact that it &apos;s so difficult , the fact that we &apos;re over@@ reaching , is the value of things like the l@@ h@@ c .	我 认为 这 任务 过于 艰难 却 仍@@ 令 我们 执@@ 着 追求 的 事实 本身 ， 就是 l@@ h@@ c 的 价值 所在
i will leave the final word to an english scientist , hu@@ m@@ ph@@ re@@ y da@@ vy , who , i su@@ spect , when def@@ ending his prote@@ ge &apos;s use@@ less experiments -- his prote@@ ge was michael far@@ ad@@ ay -- said this , &quot; nothing is so dangerous to the progress of the human mind than to assume that our views of science are ultimate , that there are no my@@ ster@@ ies in nature , that our tri@@ um@@ ph@@ s are complete , and that there are no new worlds to con@@ qu@@ er . &quot;	最后 我@@ 愿 复@@ 述 一位 英国 科学家 戴@@ 维@@ 翰 弗@@ 瑞 的话 我 记得 他 在 为 自己 学@@ 徒 无 意义 的 实验 辩@@ 护 时 — — 他 的 学@@ 徒 是 迈@@ 克尔 法@@ 拉@@ 第 — — 说 过 ： 对于 人类 头脑 发展 来说 没有 什么 比 这 想法 更为 危险 ： 认为 我们 已经 理解 了 科学 之 所有 一切 谜@@ 团 尽 已 揭@@ 开 人类 已经 大@@ 获@@ 全@@ 胜 而 停止 对 新@@ 知 的 探索
thank you .	谢谢
i am a writer .	我 是 个 作家 ， 写作 不仅仅 是 我 的 职业 ， 更@@ 是 我 一@@ 辈@@ 子 的 挚@@ 爱 与 迷@@ 恋
writing books is my profes@@ sion but it &apos;s more than that , of course .	我 是 个 作家 ， 写作 不仅仅 是 我 的 职业 ， 更@@ 是 我 一@@ 辈@@ 子 的 挚@@ 爱 与 迷@@ 恋
it is also my great li@@ fel@@ ong love and fas@@ c@@ ination .	我 是 个 作家 ， 写作 不仅仅 是 我 的 职业 ， 更@@ 是 我 一@@ 辈@@ 子 的 挚@@ 爱 与 迷@@ 恋
and i don &apos;t expect that that &apos;s ever going to change .	我 认为 这是 永远 不会 改变 的 事情
but , that said , something kind of pe@@ cu@@ liar has happened recently in my life and in my career , which has caused me to have to rec@@ ali@@ br@@ ate my whole relationship with this work .	尽@@ 管@@ 如此 ， 最近 在 我 的 生活 工作 中 ， 发生 了 一个 特殊 事件 尽@@ 管@@ 如此 ， 最近 在 我 的 生活 工作 中 ， 发生 了 一个 特殊 事件 使 我 不得不 重新 思考 我 与 我 的 工作 之间 的 关系
and the pe@@ cu@@ liar thing is that i recently wrote this book , this me@@ mo@@ ir called &quot; eat , pra@@ y , love &quot; which , deci@@ de@@ dly unlike any of my previous books , went out in the world for some reason , and became this big , me@@ ga@@ -@@ sen@@ sation , international be@@ st@@ sel@@ ler thing .	这个 特殊 事件 就是 ： 我 最新 出版 的 那@@ 本 回@@ 忆@@ 录 《 美@@ 食 、 祈祷 、 爱 》 这个 特殊 事件 就是 ： 我 最新 出版 的 那@@ 本 回@@ 忆@@ 录 《 美@@ 食 、 祈祷 、 爱 》 与 我 以前 那些 普@@ 普通@@ 通 的 作品 大@@ 不@@ 一样 不知 怎么 的 ， 成 了 一本 轰@@ 动@@ 一@@ 时 、 令人@@ 激动 的 国际 畅@@ 销@@ 书 不知 怎么 的 ， 成 了 一本 轰@@ 动@@ 一@@ 时 、 令人@@ 激动 的 国际 畅@@ 销@@ 书
the result of which is that everywhere i go now , people treat me like i &apos;m do@@ om@@ ed .	结果 是 ， 现在 不论 我 到 哪里 ， 人们 都 觉得 我 这 一@@ 辈@@ 子 就 这样 了 结果 是 ， 现在 不论 我 到 哪里 ， 人们 都 觉得 我 这 一@@ 辈@@ 子 就 这样 了
seriously -- do@@ om@@ ed , do@@ om@@ ed !	真的 ， 就 这样 了 ， 彻底 地 ， 没@@ 救 了 ， 玩@@ 完 了 ！
like , they come up to me now , all worried , and they say , &quot; aren &apos;t you afraid -- aren &apos;t you afraid you &apos;re never going to be able to top that ?	他们 会 非常 忧@@ 虑 地 过来 跟 我 说 ： “ 你 不@@ 怕 吗 ? 不@@ 怕 你 这@@ 辈@@ 子 都 超越 不了 那@@ 本书 了 吗 ? ”
aren &apos;t you afraid you &apos;re going to keep writing for your whole life and you &apos;re never again going to create a book that anybody in the world car@@ es about at all , ever again ? &quot;	“ 你 不@@ 怕 你 会 这样 写 一@@ 辈@@ 子 ， 却 永远 再也 写@@ 不@@ 出 世@@ 人 热爱 的 作品 了 吗 ？ ” “ 你 不@@ 怕 你 会 这样 写 一@@ 辈@@ 子 ， 却 永远 再也 写@@ 不@@ 出 世@@ 人 热爱 的 作品 了 吗 ？ ” “ 你 不@@ 怕 你 会 这样 写 一@@ 辈@@ 子 ， 却 永远 再也 写@@ 不@@ 出 世@@ 人 热爱 的 作品 了 吗 ？ ” “ 你 不@@ 怕 你 会 这样 写 一@@ 辈@@ 子 ， 却 永远 再也 写@@ 不@@ 出 世@@ 人 热爱 的 作品 了 吗 ？ ”
so that &apos;s reas@@ sur@@ ing , you know .	他们 可 真是 会 安@@ 慰 人 呀
but it would be worse , except for that i happen to remember that over 20 years ago , when i first started telling people -- when i was a teen@@ ager -- that i wanted to be a writer , i was met with this same kind of , sort of f@@ ear@@ -@@ based reaction .	我 的 日子 本来 会 很 难@@ 熬 ， 幸运 的 是 ， 我 想起 了 20 年前 决定 成为 作家 的 事情 我 的 日子 本来 会 很 难@@ 熬 ， 幸运 的 是 ， 我 想起 了 20 年前 决定 成为 作家 的 事情 那时 我 才 十@@ 几@@ 岁 我 当时 遭遇 到 了 同样 的 质疑 ， 人们 说 ： 你 不@@ 怕 永远 都 不会 成功 吗 ？
and people would say , &quot; aren &apos;t you afraid you &apos;re never going to have any success ?	我 当时 遭遇 到 了 同样 的 质疑 ， 人们 说 ： 你 不@@ 怕 永远 都 不会 成功 吗 ？
aren &apos;t you afraid the hu@@ mi@@ li@@ ation of re@@ jec@@ tion will kill you ?	你 不@@ 怕 持续 的 拒绝 会 把 你 击@@ 垮 吗 ？
aren &apos;t you afraid that you &apos;re going to work your whole life at this craft and nothing &apos;s ever going to come of it and you &apos;re going to die on a scra@@ p hea@@ p of broken dreams with your mouth filled with bit@@ ter as@@ h of failure ? &quot;	你 不@@ 怕 努力 终@@ 身 却 一无@@ 所@@ 成 吗 ？ 你 不@@ 怕 努力 终@@ 身 却 一无@@ 所@@ 成 吗 ？ 你 最后 会 在 支@@ 离@@ 破@@ 碎 的 梦想 中 绝望 死去 ， 满@@ 含 着 失败 的 痛@@ 楚 你 最后 会 在 支@@ 离@@ 破@@ 碎 的 梦想 中 绝望 死去 ， 满@@ 含 着 失败 的 苦@@ 痛
like that , you know .	你 最后 会 在 支@@ 离@@ 破@@ 碎 的 梦想 中 绝望 死去 ， 满@@ 含 着 失败 的 苦@@ 痛 我 当时 一直 得到 诸如此类 的 质疑
the answer -- the short answer to all those questions is , &quot; yes . &quot;	对于 这些 质疑 ， 最 简单 的 回答 是 ： “ 怕 ”
yes , i &apos;m afraid of all those things .	是 的 ， 这 种种 一切 都 让 人 害怕 ， 直到 今天 也 一样
and i always have been .	是 的 ， 这 种种 一切 都 让 人 害怕 ， 直到 今天 也 一样
and i &apos;m afraid of many , many more things be@@ sides that people can &apos;t even guess at .	其实 除了 这些 ， 我 还 害怕 很多 别人 猜 不到 的 东西 其实 除了 这些 ， 我 还 害怕 很多 别人 猜 不到 的 东西
like se@@ awe@@ ed , and other things that are scary .	比@@ 方@@ 说 海@@ 草 ， 还有 其他 吓@@ 人 的 东西
but , when it comes to writing , the thing that i &apos;ve been sort of thinking about l@@ ately , and wondering about l@@ ately , is why ?	但是 ， 说 到 害怕 写作 ， 我 最近 一直 在 想 ， 我 为什么 要 害怕 写作 呢 ？ 但是 ， 说 到 害怕 写作 ， 我 最近 一直 在 想 ， 我 为什么 要 害怕 写作 呢 ？
you know , is it rational ?	这 难道 是 一种 理性 的 想法 吗 ？
is it logical that anybody should be expected to be afraid of the work that they feel they were put on this earth to do .	人们 害怕 从事 自己 命@@ 中@@ 注@@ 定 的 工作 ？ 这 符合 逻辑 吗 ？ 人们 害怕 从事 自己 命@@ 中@@ 注@@ 定 的 工作 ？ 这 符合 逻辑 吗 ？
you know , and what is it specifically about creative ven@@ tures that seems to make us really nervous about each other &apos;s mental health in a way that other care@@ ers kind of don &apos;t do , you know ?	创造性 工作 究竟 有着 怎样 的 特@@ 殊@@ 性 ， 以至于 让 我们 为 彼此 的 心@@ 智 健康 担心 起来 了 呢 ？ 创造性 工作 究竟 有着 怎样 的 特@@ 殊@@ 性 ， 以至于 让 我们 为 彼此 的 心@@ 智 健康 担心 起来 了 呢 ？ 别的 行业 可 不太@@ 会 这样 ， 不是 吗 ？
like my dad , for example , was a chemical engineer and i don &apos;t rec@@ all once in his 40 years of chemical engineering anybody asking him if he was afraid to be a chemical engineer , you know ?	比@@ 方@@ 说 ， 我 爸爸 是 个 化学 工程师 在 他 40 年 的 化学@@ 工程 生涯 中 ， 我 不@@ 曾 记得 有人 问 他 是否 害怕 成为 化学 工程师 在 他 40 年 的 化学@@ 工程 生涯 中 ， 我 不@@ 曾 记得 有人 问 他 是否 害怕 成为 化学 工程师
it didn &apos;t -- that chemical engineering block john , how &apos;s it going ?	没人 说 ： “ 约翰 ， 化学 工作 遇到 瓶@@ 颈 了 吗 ？ 怎么样 了 ？ ”
it just didn &apos;t come up like that , you know ?	从来不 曾 发生 过 这种 问@@ 话
but to be fair , chemical engineers as a group haven &apos;t really ear@@ ned a repu@@ tation over the centuries for being al@@ co@@ ho@@ lic man@@ ic@@ -@@ de@@ pres@@ si@@ ves .	当然 ， 平@@ 心@@ 而@@ 论 ， 化学 工程师 这一 群体 并 没有 在 过去 几个 世纪 里 ， 因 酗@@ 酒 吸@@ 毒 、 狂@@ 躁 抑郁 而 享@@ 誉 全球 并 没有 在 过去 几个 世纪 里 ， 因 酗@@ 酒 吸@@ 毒 、 狂@@ 躁 抑郁 而 享@@ 誉 全球
we writ@@ ers , we kind of do have that repu@@ tation , and not just writ@@ ers , but creative people across all gen@@ res , it seems , have this repu@@ tation for being enor@@ m@@ ously mentally un@@ stable .	并 没有 在 过去 几个 世纪 里 ， 因 酗@@ 酒 吸@@ 毒 、 狂@@ 躁 抑郁 而 享@@ 誉 全球 而 我们 作家 ， 倒 确@@ 确@@ 实@@ 实 有着 那样 的 名声 不仅 作家 ， 各@@ 个@@ 领域 的 创作 人才 似乎 都 有着 情绪 极 不 稳定 的 恶@@ 名 不仅 作家 ， 各@@ 个@@ 领域 的 创作 人才 似乎 都 有着 情绪 极 不 稳定 的 恶@@ 名
and all you have to do is look at the very gri@@ m death count in the 20th century alone , of really mag@@ nific@@ ent creative minds who died young and often at their own hands , you know ?	只 需 看看 上@@ 个@@ 世纪 ， 各@@ 个@@ 领域 伟大 创作 天才 们 英@@ 年@@ 早@@ 逝 的 案例 只 需 看看 上@@ 个@@ 世纪 ， 各@@ 个@@ 领域 伟大 创作 天才 们 英@@ 年@@ 早@@ 逝 的 案例 常常 是 年@@ 纪@@ 轻@@ 轻 死 于 自杀
and even the ones who didn &apos;t literally comm@@ it suicide seem to be really un@@ done by their gi@@ fts , you know .	即使 那些 没有 自杀 的 ， 往往 也 没有 完全 展@@ 现@@ 出 他们 的 才@@ 华 即使 那些 没有 自杀 的 ， 往往 也 没有 完全 展@@ 现@@ 出 他们 的 才@@ 华
nor@@ man ma@@ il@@ er , just before he died , last interview , he said &quot; every one of my books has killed me a little more . &quot;	诺@@ 曼 梅@@ 勒 ， 在 去世 前 的 最后 一次 采访 中@@ 说 ： “ 我 的 每 一 本书 都 蚕@@ 食 了 一部分 的 我 ”
an extraordinary statement to make about your life &apos;s work , you know .	对于 你 毕@@ 生 的 作品 ， 这是 多么 激@@ 进 的 说法 啊
but we don &apos;t even blin@@ k when we hear somebody say this because we &apos;ve heard that kind of stuff for so long and somehow we &apos;ve completely inter@@ n@@ alized and accep@@ ted collec@@ tively this notion that creativity and suffering are somehow inher@@ ently linked and that arti@@ stry , in the end , will always ultimately lead to an@@ gu@@ ish .	但 我们 对 此类 说法 却 视@@ 若@@ 无@@ 睹 ， 因为 我们 早@@ 已 见@@ 怪@@ 不@@ 怪 了 但 我们 对 此类 说法 却 视@@ 若@@ 无@@ 睹 ， 因为 我们 早@@ 已 见@@ 怪@@ 不@@ 怪 了 且 不知 为何 , 人们 都 已经 完全 内@@ 化 接受 了 这 一 观念 这种 观念 就是 ： 创造力 和 痛苦 息@@ 息@@ 相关 ， 艺术 创造 最终 一定 会 导致 极度 苦@@ 闷 这种 观念 就是 ： 创造力 和 痛苦 息@@ 息@@ 相关 ， 艺术 创造 最终 一定 会 导致 极度 苦@@ 闷
and the question that i want to ask everybody here today is are you guys all cool with that idea ?	我 今天 想 问 在座 各位 的 是 ： 你们 大家 都 对此 毫无 异@@ 议 吗 ？ 我 今天 想 问 在座 各位 的 是 ： 你们 大家 都 对此 毫无 异@@ 议 吗 ？
are you comfortable with that -- because you look at it even from an in@@ ch away and , you know -- i &apos;m not at all comfortable with that assu@@ mption .	你们 都 觉得 这一 观点 毫无 问题 吗 ? 哪怕 稍@@ 稍 离@@ 远@@ 点 看 这个 观点 ， 我 也 不能 同意 这种 臆@@ 断 哪怕 稍@@ 稍 离@@ 远@@ 点 看 这个 观点 ， 我 也 不能 同意 这种 臆@@ 断
i think it &apos;s o@@ di@@ ous .	这个 观点 不@@ 但 可@@ 憎 ， 而且 可怕 ， 我 不 希望 这样 的 想法 一直 延@@ 续 到 下@@ 个@@ 世纪
and i also think it &apos;s dangerous , and i don &apos;t want to see it per@@ pe@@ tu@@ ated into the next century .	这个 观点 不@@ 但 可@@ 憎 ， 而且 可怕 ， 我 不 希望 这样 的 想法 一直 延@@ 续 到 下@@ 个@@ 世纪 这个 观点 不@@ 但 可@@ 憎 ， 而且 可怕 ， 我 不 希望 这样 的 想法 一直 延@@ 续 到 下@@ 个@@ 世纪
i think it &apos;s better if we encourage our great creative minds to live .	我 觉得 鼓励 我们 伟大 的 创作 天才 们 继续 活@@ 下去 会 更加 好
and i definitely know that , in my case -- in my situation -- it would be very dangerous for me to start sort of lea@@ king down that dark path of assu@@ mption , particularly given the circum@@ stance that i &apos;m in right now in my career .	而且 就 我 自己 来说 ， 持 这 一 观点 必@@ 然 将 我 引入 黑暗 的 绝@@ 境 而且 就 我 自己 来说 ， 持 这 一 观点 必@@ 然 将 我 引入 黑暗 的 绝@@ 境 尤其 是 在 我 目前 的 事业 阶段 尤其 是 在 我 目前 的 事业 阶段
which is -- you know , like check it out , i &apos;m pretty young , i &apos;m only about 40 years old .	你 看 ， 我 还 年轻 ， 我 才 四@@ 十 来 岁 你 看 ， 我 还 年轻 ， 我 才 四@@ 十 来 岁
i still have maybe another four decades of work left in me .	我 今@@ 后 还有 大约 四@@ 十年 的 创作 生涯
and it &apos;s ex@@ ce@@ e@@ din@@ gly likely that anything i write from this point forward is going to be jud@@ ged by the world as the work that came after the fre@@ ak@@ ish success of my last book , right ?	而且 很 有 可能 的 是 ， 从 这 一@@ 刻@@ 起 ， 我 所 写 的 每 一部 作品 都 会 被 用来 和 我 上 一本 轰@@ 动@@ 一@@ 时 的 巨@@ 作 进行 比较 ， 不是 吗 ？ 都 会 被 用来 和 我 上 一本 轰@@ 动@@ 一@@ 时 的 巨@@ 作 进行 比较 ， 不是 吗 ？
i should just put it bl@@ un@@ tly , because we &apos;re all sort of friends here now -- it &apos;s ex@@ ce@@ e@@ din@@ gly likely that my greatest success is behind me .	坦@@ 率@@ 地 说 吧 ， 看 在 我们 都 聊 了 这@@ 么@@ 久 ， 我 就 说 句 朋友 间 的 掏@@ 心 话 吧 极@@ 有 可能 的 是 ， 我 这@@ 辈@@ 子 最大 成功 已经 过去 了
oh , so je@@ sus , what a thought !	天 啊 ， 这是 何@@ 种 的 想法 ！
you know that &apos;s the kind of thought that could lead a person to start drinking g@@ in at nine o &apos;@@ clock in the morning , and i don &apos;t want to go there .	就是 这种 想法 ， 让 人 踏@@ 上 了 一 大@@ 清@@ 早 就 喝 琴@@ 酒 的 不@@ 归@@ 路 啊 就是 这种 想法 ， 让 人 踏@@ 上 了 一 大@@ 清@@ 早 就 喝 琴@@ 酒 的 不@@ 归@@ 路 啊 我 可 不想 变成 那样
i would pre@@ fer to keep doing this work that i love .	我 可 不想 变成 那样 我 希望 继续 从事 我 所 热爱 的 写作 事业 ， 所以 问题 就 变成 ： 我 应该 怎么办 呢 ？
and so , the question becomes , how ?	我 希望 继续 从事 我 所 热爱 的 写作 事业 ， 所以 问题 就 变成 ： 我 应该 怎么办 呢 ？
and so , it seems to me , upon a lot of reflec@@ tion , that the way that i have to work now , in order to continue writing , is that i have to create some sort of prote@@ ctive psychological construc@@ t , right ?	经过 一@@ 番 深入 思考 ， 在我看来 要 想 继续 写作 ， 我 必须 要 创造 出 某种 心理 保护 机制 要 想 继续 写作 ， 我 必须 要 创造 出 某种 心理 保护 机制
i have to sort of find some way to have a safe distance between me , as i am writing , and my very natural anxi@@ ety about what the reaction to that writing is going to be , from now on .	我 必须 以 某种 方式 ， 建立 起 一个 安全 距离 区别 开 写作 本身 ， 以及 我 对于 作品 反@@ 响 的 极度 焦虑 区别 开 写作 本身 ， 以及 我 对于 作品 反@@ 响 的 极度 焦虑
and , as i &apos;ve been looking over the last year for models for how to do that i &apos;ve been sort of looking across time , and i &apos;ve been trying to find other societies to see if they might have had better and san@@ er ideas than we have about how to help creative people , sort of manage the inher@@ ent emotional risks of creativity .	前 一年 ， 我 到处 找@@ 寻 可以 参@@ 考 的 模式 ， 在 历史 中 找 ， 也 在 不同 文化 中 找 前 一年 ， 我 到处 找@@ 寻 可以 参@@ 考 的 模式 ， 在 历史 中 找 ， 也 在 不同 文化 中 找 前 一年 ， 我 到处 找@@ 寻 可以 参@@ 考 的 模式 ， 在 历史 中 找 ， 也 在 不同 文化 中 找 看 他们 是否 有 比 我们 更好 、 更 理@@ 智 的 观点 来 帮助 艺术@@ 工作者 处理 艺术@@ 创作 所 固@@ 有 的 内在 情感 风险 来 帮助 艺术@@ 工作者 处理 艺术@@ 创作 所 固@@ 有 的 内在 情感 风险
and that search has led me to ancient gre@@ ece and ancient ro@@ me .	这一 寻找 最后 把 我 带到 了 古@@ 希腊 和 古@@ 罗马
so stay with me , because it does circle around and back .	所以 请 耐@@ 心 听 我 讲 ， 因为 最后 会@@ 绕 回到 我们 的 问题
but , ancient gre@@ ece and ancient ro@@ me -- people did not happen to believe that creativity came from human beings back then , o@@ .@@ k. ?	在 古@@ 希腊 和 古@@ 罗马 ， 人们 并不@@ 认为 创造力 来自 于 人类 本身 在 古@@ 希腊 和 古@@ 罗马 ， 人们 并不@@ 认为 创造力 来自 于 人类 本身 在 古@@ 希腊 和 古@@ 罗马 ， 人们 并不@@ 认为 创造力 来自 于 人类 本身
people believed that creativity was this div@@ ine atten@@ d@@ ant spirit that came to human beings from some distant and un@@ know@@ able source , for distant and un@@ know@@ able reasons .	人们 相信 ， 创造力 是 一种 神圣 的 守@@ 护 精@@ 灵 从 遥远 而 不 可@@ 知 的 地方 来到 艺术家 身边 ， 带 着 某种 遥远 而 不 可@@ 知 的 目的 从 遥远 而 不 可@@ 知 的 地方 来到 艺术家 身边 ， 带 着 某种 遥远 而 不 可@@ 知 的 目的
the gre@@ e@@ ks fam@@ ously called these div@@ ine atten@@ d@@ ant spir@@ its of creativity &quot; da@@ e@@ mon@@ s . &quot;	希@@ 腊@@ 人 普遍 地@@ 称 这种 伴随 着 创造力 的 守@@ 护 精@@ 灵 为 “ 守@@ 护@@ 神 ”
so@@ cr@@ ates , fam@@ ously , believed that he had a da@@ em@@ on who spoke wisdom to him from af@@ ar .	当时 人们 普遍 地 认为 苏@@ 格@@ 拉@@ 底 就 有 这样 一个 守@@ 护@@ 神 ， 从 远@@ 处 赋予 他 智慧 当时 人们 普遍 地 认为 苏@@ 格@@ 拉@@ 底 就 有 这样 一个 守@@ 护@@ 神 ， 从 远@@ 处 赋予 他 智慧
the roman@@ s had the same idea , but they called that sort of dise@@ m@@ bo@@ died creative spirit a genius .	古@@ 罗马 人 有着 相似 的 观点 ， 他们 把 这种 无@@ 形 的 创造 精@@ 灵 称为 “ 天才 ” 古@@ 罗马 人 有着 相似 的 观点 ， 他们 把 这种 无@@ 形 的 创造 精@@ 灵 称为 “ 天才 ”
which is great , because the roman@@ s did not actually think that a genius was a particularly clever individual .	这种 观点 很@@ 妙 ， 因为 罗马 人 并 没有 认为 “ 天才 ” 是 某个 特别 聪@@ 慧 的 个人 这种 观点 很@@ 妙 ， 因为 罗马 人 并 没有 认为 “ 天才 ” 是 某个 特别 聪@@ 慧 的 个人
they believed that a genius was this , sort of ma@@ gical div@@ ine enti@@ ty , who was believed to literally live in the walls of an artist &apos;s studio , kind of like do@@ bby the house el@@ f , and who would come out and sort of in@@ vi@@ si@@ bly assi@@ st the artist with their work and would shape the outcome of that work .	他们 认为 “ 天才 ” 是 某种 奇妙 的 神圣 存在 他们 甚至 认为 “ 天才 ” 居住 在 艺术家 工作室 的 墙@@ 壁 中 ， 就 像 小@@ 精@@ 灵 多@@ 比 一样 他们 甚至 认为 “ 天才 ” 居住 在 艺术家 工作室 的 墙@@ 壁 中 ， 就 像 小@@ 精@@ 灵 多@@ 比 一样 它们 会 悄@@ 悄@@ 地 钻@@ 出来 ， 无@@ 形 地 帮助 艺术家 创作 ， 并 影响 作品 成@@ 败 它们 会 悄@@ 悄@@ 地 钻@@ 出来 ， 无@@ 形 地 帮助 艺术家 创作 ， 并 影响 作品 成@@ 败
so brilliant -- there it is , right there , that distance that i &apos;m talking about -- that psychological construc@@ t to protect you from the results of your work .	这个 观点 简直 绝 了 ， 这 就是 我 在 找@@ 寻 的 那个 安全 距离 这 就是 让 人 免@@ 受 作品 成@@ 败 影响 的 心理 保护 机制
and everyone knew that this is how it func@@ tioned , right ?	我们 都 可以 理解 它 的 运作 模式 ， 不是 吗 ？
so the ancient artist was protected from certain things , like , for example , too much nar@@ ci@@ ssi@@ sm , right ?	古@@ 代 艺术家 由 这个 观点 而 得到 保护 ， 避免 了 过度 自@@ 恋 古@@ 代 艺术家 由 这个 观点 而 得到 保护 ， 避免 了 过度 自@@ 恋
if your work was brilliant you couldn &apos;t take all the credit for it , everybody knew that you had this dise@@ m@@ bo@@ died genius who had helped you .	如果 你 的 作品 很 伟大 ， 那 可 不能 完全 归@@ 功@@ 于 你 因为 大家 都 知道 你 是 在 一个 无@@ 形 的 “ 天才 ” 帮助 下 完成 作品 的
if your work bom@@ bed , not entirely your fa@@ ult , you know ?	如果 你 的 作品 很@@ 烂 ， 同样 也 不@@ 全@@ 是 你 的 错
everyone knew your genius was kind of la@@ me .	人人 都 知道 那 是因为 你 的 “ 天才 ” 很 差@@ 劲
and this is how people thought about creativity in the west for a really long time .	这 就是 西@@ 方@@ 人 在 过去 很长 一段时间 里 看待 创@@ 作@@ 力 的 方式
and then the ren@@ a@@ is@@ s@@ ance came and everything changed , and we had this big idea , and the big idea was let &apos;s put the individual human being at the center of the universe above all go@@ ds and my@@ ster@@ ies , and there &apos;s no more room for my@@ sti@@ cal creatures who take dic@@ tation from the div@@ ine .	接着 文@@ 艺@@ 复@@ 兴 来@@ 临 ， 一切 都 变 了 ， 人们 产生 了 一个 伟大 的 想法 ： 接着 文@@ 艺@@ 复@@ 兴 来@@ 临 ， 一切 都 变 了 ， 人们 产生 了 一个 伟大 的 想法 ： “ 让 我们 把 人类 置@@ 于 宇宙 中心 ， 超越 众@@ 神 和 神秘 未知 ” “ 让 我们 把 人类 置@@ 于 宇宙 中心 ， 超越 众@@ 神 和 神秘 未知 ” 于是 再也 没有 空间 留给 传递 神圣 意@@ 志 的 小@@ 精@@ 灵
and it &apos;s the beginning of rational human@@ ism , and people started to believe that creativity came completely from the self of the individual .	这 就是 理性 人@@ 文@@ 主义 的 开@@ 端 ， 人们 开始 相信 创造力 完全 来源于 人类 个体 本身 这 就是 理性 人@@ 文@@ 主义 的 开@@ 端 ， 人们 开始 相信 创造力 完全 来源于 人类 个体 本身 这 就是 理性 人@@ 文@@ 主义 的 开@@ 端 ， 人们 开始 相信 创造力 完全 来源于 人类 个体 本身
and for the first time in history , you start to hear people refer@@ ring to this or that artist as being a genius rather than having a genius .	有史以来 ， 人们 第一次 将 某个 艺术家 称为 “ 天才 ” ， 而 非 拥有 一个 “ 天才 ” 有史以来 ， 人们 第一次 将 某个 艺术家 称为 “ 天才 ” ， 而 非 拥有 一个 “ 天才 ” 有史以来 ， 人们 第一次 将 某个 艺术家 称为 “ 天才 ” ， 而 非 拥有 一个 “ 天才 ”
and i got to tell you , i think that was a huge error .	而 我 要说 的 是 ， 我 认为 那 是 一个 巨大 的 错误
you know , i think that allowing somebody , one m@@ ere person to believe that he or she is like , the ves@@ sel , you know , like the f@@ on@@ t and the ess@@ ence and the source of all div@@ ine , creative , un@@ know@@ able , e@@ ternal mystery is just a s@@ mi@@ dge too much responsibility to put on one fra@@ gile , human psy@@ ch@@ e .	让 一个 人 ， 区@@ 区 一个 个体 去 相信 他 是 承@@ 载 着 神圣 、 创造 、 未知 和 永@@ 恒 这些 事物 的 源@@ 泉 与 圣@@ 器 去 相信 他 是 承@@ 载 着 神圣 、 创造 、 未知 和 永@@ 恒 这些 事物 的 源@@ 泉 与 圣@@ 器 去 相信 他 是 承@@ 载 着 神圣 、 创造 、 未知 和 永@@ 恒 这些 事物 的 源@@ 泉 与 圣@@ 器 无@@ 异@@ 于 要求 他 吞@@ 下 太阳 ， 这 对于 脆弱 的 个体 而言 ， 是 太@@ 大 的 责任
it &apos;s like asking somebody to s@@ wal@@ low the sun .	无@@ 异@@ 于 要求 他 吞@@ 下 太阳 ， 这 对于 脆弱 的 个体 而言 ， 是 太@@ 大 的 责任
it just completely war@@ ps and di@@ stor@@ ts e@@ gos , and it creates all these un@@ mana@@ ge@@ able expectations about performance .	这 彻底 地 扭@@ 曲 了 一个 人 的 自我 认知 ， 并 导致 对于 个人 成就 无比 膨胀 的 预期 这 彻底 地 扭@@ 曲 了 一个 人 的 自我 认知 ， 并 导致 对于 个人 成就 无比 膨胀 的 预期
and i think the pressure of that has been killing off our artists for the last 500 years .	我 认为 就是 这种 压力 ， 在 过去 的 500 年间 扼@@ 杀 了 无数 艺术家 我 认为 就是 这种 压力 ， 在 过去 的 500 年间 扼@@ 杀 了 无数 艺术家
and , if this is true , and i think it is true , the question becomes , what now ?	如果 真是 这样 至少 我 认为 是 这样 的 那么 我们 的 问题 就是 ： 现在 该 怎么办 ？ 我们 能够 改变 这种 状况 吗 ？
can we do this differently ?	那么 我们 的 问题 就是 ： 现在 该 怎么办 ？ 我们 能够 改变 这种 状况 吗 ？
maybe go back to some more ancient understanding about the relationship between humans and the creative mystery .	也许 我们 应 回到 更 古老 的 过去 ， 去 参@@ 考 他们 对于 人类 与 创造力 的 理解 ？ 也许 我们 应 回到 更 古老 的 过去 ， 去 参@@ 考 他们 对于 人类 与 创造力 的 理解 ？
maybe not .	也许 不行
maybe we can &apos;t just er@@ ase 500 years of rational human@@ istic thought in one 18 minute speech .	我们 无法 用 一个 短@@ 短 18 分钟 的 演讲 ， 抹 杀@@ 掉 发展 了 500 多年 的 理性 人@@ 文 思想 我们 无法 用 一个 短@@ 短 18 分钟 的 演讲 ， 抹 杀@@ 掉 发展 了 500 多年 的 理性 人@@ 文 思想
and there &apos;s probably people in this audience who would raise really legi@@ timate scientific susp@@ ici@@ ons about the notion of , basically fa@@ i@@ ries who follow people around ru@@ bb@@ ing fair@@ y ju@@ ice on their projects and stuff .	况@@ 且 或许 今天 的 听众 中 ， 就 有人 能够 提出 有@@ 理@@ 有@@ 据 的 科学 质疑 况@@ 且 或许 今天 的 听众 中 ， 就 有人 能够 提出 有@@ 理@@ 有@@ 据 的 科学 质疑 批@@ 驳 这种 童@@ 话 精@@ 灵 跟着 艺术家 主@@ 人 ， 给 作品 上@@ 点 上 神@@ 仙 水 的 可@@ 笑 想法 批@@ 驳 这种 童@@ 话 精@@ 灵 跟着 艺术家 主@@ 人 ， 给 作品 上@@ 点 上 神@@ 仙 水 的 可@@ 笑 想法
i &apos;m not , probably , going to bring you all along with me on this .	也许 ， 我 无法 说服 你们 大家 都 同意 我 的 看法
but the question that i kind of want to pose is -- you know , why not ?	但 我 想 说 的 是 ： 为何 不 呢 ？ 为什么 不@@ 换@@ 个 角度 思考 呢 ？ 但 我 想 说 的 是 ： 为何 不 呢 ？ 为什么 不@@ 换@@ 个 角度 思考 呢 ？
why not think about it this way ?	但 我 想 说 的 是 ： 为何 不 呢 ？ 为什么 不@@ 换@@ 个 角度 思考 呢 ？
because it makes as much sense as anything else i have ever heard in terms of expla@@ ining the u@@ tter ma@@ dd@@ ening ca@@ pri@@ ci@@ ousness of the creative process .	就 各种 解释 人类 变@@ 化@@ 无@@ 常 的 创作 过程 的 理论 而言 这个 精@@ 灵 理论 和 我 听 过 的 所有 其他 理论 一样 地 合理 （ 或者说 一样 地 无@@ 理 ） 这个 精@@ 灵 理论 和 我 听 过 的 所有 其他 理论 一样 地 合理 （ 或者说 一样 地 无@@ 理 ）
a process which , as anybody who has ever tried to make something -- which is to say basically everyone here --- knows does not always behave ra@@ tionally .	这个 过程 ， 对于 任何 一个 曾 试图 创作 的 人 来说 相信 在 坐 各位 都 曾 有 这方面 的 经历 都 会 知道 创作 过程 并 不 总是 理性 的
and , in fact , can sometimes feel down@@ right par@@ an@@ or@@ mal .	实际上 ， 创作 过程 有时 简直 就是 超@@ 乎 常@@ 理
i had this en@@ counter recently where i met the extraordinary american po@@ et ru@@ th stone , who &apos;s now in her 9@@ 0s , but she &apos;s been a po@@ et her entire life and she told me that when she was growing up in rural virg@@ in@@ ia , she would be out working in the fields , and she said she would feel and hear a poem coming at her from over the landscape .	比@@ 方@@ 说 ， 我 最近 见到 杰出 的 美国 诗人 露@@ 丝 . 斯@@ 通 露@@ 丝 已经 九@@ 十@@ 多@@ 岁 ， 她 一直 是 一位 诗人 她 对 我 说 她 少年 时 生活 在 弗@@ 吉@@ 尼亚 乡@@ 间 的 事情 她 会 在 田@@ 间 劳@@ 作 着 ， 然后 突然 听到 并 感觉 到 一首 诗 ， 从 远@@ 处 冲 她 而 来 她 会 在 田@@ 间 劳@@ 作 着 ， 然后 突然 听到 并 感觉 到 一首 诗 ， 从 远@@ 处 冲 她 而 来 她 会 在 田@@ 间 劳@@ 作 着 ， 然后 突然 听到 并 感觉 到 一首 诗 ， 从 远@@ 处 冲 她 而 来
and she said it was like a th@@ under@@ ous train of air .	像 一@@ 股 雷@@ 鸣@@ 般 的 气@@ 息 ， 朝 她 倾@@ 泻 而 下
and it would come bar@@ re@@ ling down at her over the landscape .	她 可以 感受 到 它 的 来@@ 临 ， 因为 这 股 力量 会 撼@@ 动 她 脚@@ 下 的 大@@ 地
and she felt it coming , because it would shake the earth under her feet .	她 可以 感受 到 它 的 来@@ 临 ， 因为 这 股 力量 会 撼@@ 动 她 脚@@ 下 的 大@@ 地
she knew that she had only one thing to do at that point , and that was to , in her words , &quot; run like hell . &quot;	每当 此时 ， 她 唯一 能 做 的 只有 一件 事 用 她 的话 说 ， 就是 “ 死@@ 命 地 狂@@ 奔 ”
and she would run like hell to the house and she would be getting cha@@ sed by this poem , and the whole deal was that she had to get to a piece of paper and a pen@@ cil fast enough so that when it th@@ under@@ ed through her , she could collect it and grab it on the page .	她 会 狂@@ 奔 回家 里 ， 这@@ 首 诗@@ 则 会 一@@ 路 追@@ 逐 着 她 她 会 狂@@ 奔 回家 里 ， 这@@ 首 诗@@ 则 会 一@@ 路 追@@ 逐 着 她 她 需要 飞@@ 快 地 找到 纸@@ 笔 ， 从而 在 这@@ 股 力量 穿过 她 时 ， 捕@@ 捉 住 那@@ 首 诗 ， 把 它 记 在 纸 上 她 需要 飞@@ 快 地 找到 纸@@ 笔 ， 从而 在 这@@ 股 力量 穿过 她 时 ， 捕@@ 捉 住 那@@ 首 诗 ， 把 它 记 在 纸 上 她 需要 飞@@ 快 地 找到 纸@@ 笔 ， 从而 在 这@@ 股 力量 穿过 她 时 ， 捕@@ 捉 住 那@@ 首 诗 ， 把 它 记 在 纸 上
and other times she wouldn &apos;t be fast enough , so she &apos;d be running and running and running , and she wouldn &apos;t get to the house and the poem would bar@@ re@@ l through her and she would miss it and she said it would continue on across the landscape , looking , as she put it &quot; for another po@@ et . &quot;	有些 时候 她 则 不够 快 她 拼@@ 命 地 跑 ， 还 没@@ 到 家 ， 那@@ 首 诗 已经 奔@@ 腾 而 过 ， 于是 她 便 错@@ 过 了 那@@ 首 诗 她 拼@@ 命 地 跑 ， 还 没@@ 到 家 ， 那@@ 首 诗 已经 奔@@ 腾 而 过 ， 于是 她 便 错@@ 过 了 那@@ 首 诗 她 说 那@@ 首 诗@@ 会 继续 在 田@@ 野 间 穿@@ 行 ， 寻找 “ 下 一位 诗人 ” 她 说 那@@ 首 诗@@ 会 继续 在 田@@ 野 间 穿@@ 行 ， 寻找 “ 下 一位 诗人 ”
and then there were these times -- this is the piece i never for@@ got -- she said that there were moments where she would almost miss it , right ?	在 另 一些 时候 ， 这 是 最 叫 我 难@@ 忘 的 部分 ： 在 另 一些 时候 ， 这 是 最 叫 我 难@@ 忘 的 部分 ： 她 说 有些 时候 她 几乎 就要 错@@ 过 一首 诗 了
so , she &apos;s running to the house and she &apos;s looking for the paper and the poem pas@@ ses through her , and she gr@@ ab@@ s a pen@@ cil just as it &apos;s going through her , and then she said , it was like she would reach out with her other hand and she would catch it .	她 飞@@ 奔 回家 ， 寻找 纸@@ 笔 而 那@@ 首 诗 即将 穿越 她 而 去 ， 她 在 它 正@@ 要 穿过 之@@ 际 抓住 了 笔 而 那@@ 首 诗 即将 穿越 她 而 去 ， 她 在 它 正@@ 要 穿过 之@@ 际 抓住 了 笔 然后 她 会 伸@@ 出 另@@ 一只 手 ， 抓住 那@@ 首 诗 的 尾巴 然后 她 会 伸@@ 出 另@@ 一只 手 ， 抓住 那@@ 首 诗 的 尾巴
she would catch the poem by its tail , and she would pull it backwards into her body as she was tran@@ scri@@ bing on the page .	然后 她 会 伸@@ 出 另@@ 一只 手 ， 抓住 那@@ 首 诗 的 尾巴 把 它 顺@@ 势 拉@@ 回来 ， 另@@ 一只 手 则 一边 将 诗@@ 句 誊@@ 写 在 纸 上 把 它 顺@@ 势 拉@@ 回来 ， 另@@ 一只 手 则 一边 将 诗@@ 句 誊@@ 写 在 纸 上
and in these inst@@ ances , the poem would come up on the page perfect and in@@ t@@ act but backwards , from the last word to the first .	每当 这种 时候 ， 诗 会 完@@ 好@@ 无@@ 缺 地 呈现 在 纸 上 只不过 顺序 是 颠@@ 倒 的 ， 从 最后 那个 词 开始 ， 由@@ 后 往@@ 前 ， 一直 到 第一个 词
so when i heard that i was like -- that &apos;s un@@ can@@ ny , that &apos;s exactly what my creative process is like .	只不过 顺序 是 颠@@ 倒 的 ， 从 最后 那个 词 开始 ， 由@@ 后 往@@ 前 ， 一直 到 第一个 词 我 听 了 她 的 故事 后 ， 心@@ 想 ： 太 不可思议 了 ， 这 和 我 的 创作 过程 一@@ 模@@ 一样 ！ 我 听 了 她 的 故事 后 ， 心@@ 想 ： 太 不可思议 了 ， 这 和 我 的 创作 过程 一@@ 模@@ 一样 ！
that &apos;s not at all what my creative process is -- i &apos;m not the pi@@ pe@@ line !	我 听 了 她 的 故事 后 ， 心@@ 想 ： 太 不可思议 了 ， 这 和 我 的 创作 过程 一@@ 模@@ 一样 ！ 当然 这 并非 我 创作 过程 的 全部 ， 我 不是 管道 ， 我 的 工作 方式 更 像是 一头 骡@@ 子
i &apos;m a mu@@ le , and the way that i have to work is that i have to get up at the same time every day , and swe@@ at and labor and bar@@ re@@ l through it really aw@@ k@@ war@@ dly .	当然 这 并非 我 创作 过程 的 全部 ， 我 不是 管道 ， 我 的 工作 方式 更 像是 一头 骡@@ 子 我 必须 每天 同@@ 一@@ 时间 起@@ 床 ， 然后 笨@@ 拙 地 ， 勤@@ 恳 地 工作 我 必须 每天 同@@ 一@@ 时间 起@@ 床 ， 然后 笨@@ 拙 地 ， 勤@@ 恳 地 工作
but even i , in my mu@@ li@@ sh@@ ness , even i have bru@@ shed up against that thing , at times .	不过 即使 古@@ 板 如 我 ， 偶@@ 尔 也 会 意外 地 得到 不可思议 的 灵感 不过 即使 古@@ 板 如 我 ， 偶@@ 尔 也 会 意外 地 得到 不可思议 的 灵感
and i would imagine that a lot of you have too .	在 坐 很多 人 或许 也 有 类似 经历
you know , even i have had work or ideas come through me from a source that i honest@@ ly cannot identify .	你 想 ， 即使 像 我 这样 墨@@ 守@@ 成@@ 规 的 人 ， 也 会 遇到 不知 何@@ 处 而来 的 灵感 你 想 ， 即使 像 我 这样 墨@@ 守@@ 成@@ 规 的 人 ， 也 会 遇到 不知 何@@ 处 而来 的 灵感
and what is that thing ?	这 到底 是 怎么回事 呢 ？
and how are we to relate to it in a way that will not make us lose our minds , but , in fact , might actually keep us san@@ e ?	我们 要 以 怎样 的 方式 看待 它 ， 才 不会 丧@@ 失@@ 理@@ 智 呢 ？ 我们 要 以 怎样 的 方式 看待 它 ， 才 不会 丧@@ 失@@ 理@@ 智 呢 ？
and for me , the best con@@ temporary example that i have of how to do that is the musici@@ an tom wa@@ its , who i got to interview several years ago on a magazine as@@ sign@@ ment .	就 我 所知 的 当@@ 代 艺术家 中 ， 将 这 一 问题 处理 得 最好 的 是 音乐家 汤@@ 姆 威@@ 兹 就 我 所知 的 当@@ 代 艺术家 中 ， 将 这 一 问题 处理 得 最好 的 是 音乐家 汤@@ 姆 威@@ 兹 几年 前 ， 我 就 一个 杂志 工作 采访 过 他 ， 当时 我们 谈@@ 及 了 这 一 问题
and we were talking about this , and you know , tom , for most of his life he was pretty much the em@@ bo@@ di@@ ment of the tor@@ mented con@@ temporary modern artist , trying to control and manage and domin@@ ate these sort of un@@ contro@@ l@@ l@@ able creative im@@ pul@@ ses that were totally inter@@ n@@ alized .	几年 前 ， 我 就 一个 杂志 工作 采访 过 他 ， 当时 我们 谈@@ 及 了 这 一 问题 汤@@ 姆 是 备@@ 受 创作 压力 折磨 的 现代 艺术家 的 典型 汤@@ 姆 是 备@@ 受 创作 压力 折磨 的 现代 艺术家 的 典型 大@@ 半@@ 生 时间 ， 他 都 在 努力 地 控制 , 管理 并 主@@ 宰 那 不 可@@ 控 的 内在 创作 灵感 大@@ 半@@ 生 时间 ， 他 都 在 努力 地 控制 , 管理 并 主@@ 宰 那 不 可@@ 控 的 内在 创作 灵感 大@@ 半@@ 生 时间 ， 他 都 在 努力 地 控制 , 管理 并 主@@ 宰 那 不 可@@ 控 的 内在 创作 灵感
but then he got older , he got cal@@ mer , and one day he was driving down the free@@ way in los angeles he told me , and this is when it all changed for him .	但 随着 年纪 渐@@ 长 ， 他 变得 沉@@ 静 内@@ 敛 了 他 告诉 我 说 ： 一天 他 在 洛杉矶 高速@@ 公路 开车 ， 这时 发生 了 一件 改变 他 一生 的 事情 他 告诉 我 说 ： 一天 他 在 洛杉矶 高速@@ 公路 开车 ， 这时 发生 了 一件 改变 他 一生 的 事情
and he &apos;s spe@@ eding along , and all of a sudden he hear@@ s this little fra@@ gment of me@@ lo@@ dy , that comes into his head as inspiration often comes , el@@ u@@ sive and tan@@ tal@@ izing , and he wants it , you know , it &apos;s gor@@ geous , and he lon@@ gs for it , but he has no way to get it .	他 正在 加速 前@@ 行 ， 突然 ， 他 隐@@ 约 听到 了 一小 段 优@@ 美 的 旋@@ 律 ♪ ♪ 他 正在 加速 前@@ 行 ， 突然 ， 他 隐@@ 约 听到 了 一小 段 优@@ 美 的 旋@@ 律 ♪ ♪ 这 旋@@ 律 莫@@ 名 地 进入 他 的 脑@@ 海 ， 就 像 灵感 来 临时 那样 ， 捉@@ 摸@@ 不@@ 定 而 诱@@ 人 心@@ 弦 这 旋@@ 律 莫@@ 名 地 进入 他 的 脑@@ 海 ， 就 像 灵感 来 临时 那样 ， 捉@@ 摸@@ 不@@ 定 而 诱@@ 人 心@@ 弦 他 急@@ 切 地 想要 捕@@ 捉 它 ， 但是 没有 办法 ， 他 既 没有 纸@@ 笔 ， 也 没有 录@@ 音@@ 机
he doesn &apos;t have a piece of paper , he doesn &apos;t have a pen@@ cil , he doesn &apos;t have a tape rec@@ order .	他 急@@ 切 地 想要 捕@@ 捉 它 ， 但是 没有 办法 ， 他 既 没有 纸@@ 笔 ， 也 没有 录@@ 音@@ 机 他 急@@ 切 地 想要 捕@@ 捉 它 ， 但是 没有 办法 ， 他 既 没有 纸@@ 笔 ， 也 没有 录@@ 音@@ 机
so he starts to feel all of that old anxi@@ ety start to rise in him like , &quot; i &apos;m going to lose this thing , and then i &apos;m going to be ha@@ un@@ ted by this song forever .	他 感觉 到 那种 熟悉 的 创作 焦虑 又 在 他 体内 集@@ 聚 “ 我 就要 失去 这个 灵感 了 ， 然后 这@@ 首 曲子 会 永@@ 世 阴@@ 魂@@ 不@@ 散 地 折磨 我 ” “ 我 就要 失去 这个 灵感 了 ， 然后 这@@ 首 曲子 会 永@@ 世 阴@@ 魂@@ 不@@ 散 地 折磨 我 ”
i &apos;m not good enough , and i can &apos;t do it . &quot;	“ 我 根本 不行 ， 我 做 不到 ”
and instead of pan@@ ic@@ king , he just stopped .	突然 ， 他 奇@@ 异 般@@ 地 停止 了 继续 抓@@ 狂 和 焦@@ 躁 情绪 ， 然后 做 了 一件 不 寻常 的 事情
he just stopped that whole mental process and he did something completely novel .	突然 ， 他 奇@@ 异 般@@ 地 停止 了 继续 抓@@ 狂 和 焦@@ 躁 情绪 ， 然后 做 了 一件 不 寻常 的 事情 突然 ， 他 奇@@ 异 般@@ 地 停止 了 继续 抓@@ 狂 和 焦@@ 躁 情绪 ， 然后 做 了 一件 不 寻常 的 事情
he just looked up at the sky , and he said , &quot; exc@@ use me , can you not see that i &apos;m driving ? &quot;	他 抬@@ 头 望 向 天空 ， 对 它 说道 ： “ 不@@ 好@@ 意思 ， 您 没 看到 我 正在 开车 吗 ？ ” 他 抬@@ 头 望 向 天空 ， 对 它 说道 ： “ 不@@ 好@@ 意思 ， 您 没 看到 我 正在 开车 吗 ？ ”
&quot; do i look like i can write down a song right now ?	他 抬@@ 头 望 向 天空 ， 对 它 说道 ： “ 不@@ 好@@ 意思 ， 您 没 看到 我 正在 开车 吗 ？ ” 我 看上去 像是 能 立@@ 马 记@@ 下 一首 曲子 的 样子 吗 ？
if you really want to exist , come back at a more opport@@ une moment when i can take care of you .	如果 你 真@@ 想 在 世上 流@@ 传 ， 另 挑@@ 个 合适 的 时间 再@@ 来 吧 ， 在 我 方便 的 时候 如果 你 真@@ 想 在 世上 流@@ 传 ， 另 挑@@ 个 合适 的 时间 再@@ 来 吧 ， 在 我 方便 的 时候
otherwise , go bo@@ ther somebody else today .	或者 ， 你 可以 今天 去 骚@@ 扰 别人 ， 去 找 莱@@ 昂@@ 纳@@ 德 · 科@@ 恩 去
go bo@@ ther le@@ on@@ ard co@@ h@@ en . &quot;	或者 ， 你 可以 今天 去 骚@@ 扰 别人 ， 去 找 莱@@ 昂@@ 纳@@ 德 · 科@@ 恩 去
and his whole work process changed after that .	自从 那@@ 件事 以后 ， 汤@@ 姆 的 整个 创作 过程 改变 了
not the work , the work was still of@@ t@@ enti@@ mes as dark as ever .	不是 作品 变 了 ， 他 的 作品 仍 是 一@@ 如@@ 既@@ 往 的 黑暗
but the process , and the heavy anxi@@ ety around it was released when he took the gen@@ ie , the genius out of him where it was causing nothing but trouble , and released it kind of back where it came from , and realized that this didn &apos;t have to be this inter@@ n@@ alized , tor@@ mented thing .	但 当 他 把 创作 天才 从 自身 剥@@ 离 开来 时 ， 伴随 着 创作 过程 的 严重 焦虑 也 被 化@@ 解 了 但 当 他 把 创作 天才 从 自身 剥@@ 离 开来 时 ， 伴随 着 创作 过程 的 严重 焦虑 也 被 化@@ 解 了 将 创作 灵感 归@@ 于 自我 ， 只是 带来 痛苦 与 麻烦 ， 将 它 解@@ 放@@ 出来 ， 倒@@ 像 是 放@@ 归 原@@ 处 同时 他 也 意识 到 ， 他 原本 无@@ 需 将 创作 灵感 内@@ 化 于 自身 ， 自我 折磨
it could be this pe@@ cu@@ liar , won@@ d@@ rou@@ s , bi@@ zar@@ re collaboration kind of conversation between tom and the strange , ex@@ ternal thing that was not quite tom .	创作 灵感 可以 是 他 和 这 一 外部 未知 存在 之间 奇@@ 异 、 奇妙 又 奇怪 的 合作 关系 创作 灵感 可以 是 他 和 这 一 外部 未知 存在 之间 奇@@ 异 、 奇妙 又 奇怪 的 合作 关系 那 是 一个 自身 以外 的 存在
so when i heard that story it started to shift a little bit the way that i worked too , and it already saved me once .	这个 故事 潜@@ 移@@ 默@@ 化 地 改变 了 我 的 工作 方式 ， 这一 转变 已经 拯救 了 我 一次 这个 故事 潜@@ 移@@ 默@@ 化 地 改变 了 我 的 工作 方式 ， 这一 转变 已经 拯救 了 我 一次
this idea , it saved me when i was in the middle of writing &quot; eat , pra@@ y , love , &quot; and i fell into one of those , sort of p@@ its of desp@@ air that we all fall into when we &apos;re working on something and it &apos;s not coming and you start to think this is going to be a disaster , this is going to be the worst book ever written .	那 是 在 写 《 美@@ 食 、 祈祷 、 爱 》 的 时候 ， 我 陷入 了 一个 焦虑 绝望 的 无@@ 底@@ 洞 那 是 在 写 《 美@@ 食 、 祈祷 、 爱 》 的 时候 ， 我 陷入 了 一个 焦虑 绝望 的 无@@ 底@@ 洞 那种 不断 努力 却 毫无 灵感 的 绝望 低@@ 潮 状态 然后 你 渐渐 觉得 这部 作品 将 成为 一个 彻底 的 失败 成为 有史以来 最@@ 烂 的 一 本书
not just bad , but the worst book ever written .	不仅 是 烂 ， 而且 是 彻底 的 糟@@ 糕@@ 透@@ 顶 ， 我 开始 觉得 我 应该 放弃 写 这 本书
and i started to think i should just du@@ mp this project .	不仅 是 烂 ， 而且 是 彻底 的 糟@@ 糕@@ 透@@ 顶 ， 我 开始 觉得 我 应该 放弃 写 这 本书
but then i rememb@@ ered tom talking to the open air and i tried it .	这时 我 想起 了 汤@@ 姆 对 着 天空 喊@@ 话 的 事情 ， 然后 我 试@@ 了@@ 试 这时 我 想起 了 汤@@ 姆 对 着 天空 喊@@ 话 的 事情 ， 然后 我 试@@ 了@@ 试
so i just li@@ fted my face up from the man@@ us@@ cri@@ pt and i direc@@ ted my comm@@ ents to an empty corner of the room .	我 从 手@@ 稿 中 抬@@ 起 头 ， 转向 房间 中 的 一个 空 角落 我 从 手@@ 稿 中 抬@@ 起 头 ， 转向 房间 中 的 一个 空 角落
and i said al@@ ou@@ d , &quot; listen you , thing , you and i both know that if this book isn &apos;t brilliant that is not entirely my fa@@ ult , right ?	然后 大@@ 声 宣布 道 ： “ 你 这个 家伙 ， 给 我 听 着 ” “ 咱@@ 俩 都 知道 ， 如果 这 本书 不@@ 怎么样 ， 那 可不是 我 一个 人 的 错 ， 不是 吗 ？ ” “ 咱@@ 俩 都 知道 ， 如果 这 本书 不@@ 怎么样 ， 那 可不是 我 一个 人 的 错 ， 不是 吗 ？ ”
because you can see that i am putting everything i have into this , i don &apos;t have any more than this .	“ 因为 你 可以 看到 ， 我 已经 为 之 倾@@ 尽@@ 全@@ 力 毫无@@ 保留 了 ” “ 因为 你 可以 看到 ， 我 已经 为 之 倾@@ 尽@@ 全@@ 力 毫无@@ 保留 了 ”
so if you want it to be better , then you &apos;ve got to show up and do your part of the deal .	“ 你 若 是 想要 这 本书 更好 一些 ， 现在 轮@@ 到 你 出@@ 面 ， 做 你 那 部分 工作 了 ”
o@@ .@@ k. but if you don &apos;t do that , you know what , the hell with it .	“ 你 要是 不 来 帮忙 ， 那 就 见 你 的 鬼 去 吧 ”
i &apos;m going to keep writing anyway because that &apos;s my job .	" 我 还是 会 继续 写@@ 下去 的 ， 因为 这 是 我 的 工作 "
and i would please like the record to reflect today that i showed up for my part of the job . &quot;	我 希望 今天 的 历史@@ 记录 证明 ： 我 尽@@ 责 地 坚@@ 守 了 我 的 岗@@ 位 € 我 希望 今天 的 历史@@ 记录 证明 ： 我 尽@@ 责 地 坚@@ 守 了 我 的 岗@@ 位
because -- in the end it &apos;s like this , o@@ .@@ k. -- centuries ago in the deser@@ ts of north africa , people used to ga@@ ther for these mo@@ on@@ light dan@@ ces of sac@@ red dance and music that would go on for hours and hours , until da@@ wn .	我 希望 今天 的 历史@@ 记录 证明 ： 我 尽@@ 责 地 坚@@ 守 了 我 的 岗@@ 位 因为 因为 最后 就是 这样 的 在 几个 世纪 前 的 北@@ 非 沙漠 里 ， 人们 会 在 月@@ 色 下 举行 神圣 的 歌@@ 舞 聚会 在 几个 世纪 前 的 北@@ 非 沙漠 里 ， 人们 会 在 月@@ 色 下 举行 神圣 的 歌@@ 舞 聚会 聚会 持续 数@@ 个 小时 直@@ 至 天@@ 亮
and they were always mag@@ nific@@ ent , because the dan@@ cers were profes@@ sion@@ als and they were terri@@ fic , right ?	那些 表演 很 精彩 ， 因为 他们 都 是 很棒 的 专业 舞@@ 者 那些 表演 很 精彩 ， 因为 他们 都 是 很棒 的 专业 舞@@ 者
but every once in a while , very r@@ arely , something would happen , and one of these perfor@@ mers would actually become tran@@ scen@@ dent .	偶@@ 尔 的 时候 ， 虽然 很少 见 ， 但 确@@ 确@@ 实@@ 实 会 发生 某 一位 舞@@ 者 会 超越 当下 ， 超@@ 然 出@@ 世
and i know you know what i &apos;m talking about , because i know you &apos;ve all seen , at some point in your life , a performance like this .	你们 应该 都 知道 我 说 的 这种 情况 因为 大家 都 曾 在 某个 时刻 ， 见@@ 识 过 那样 的 表演
it was like time would stop , and the dan@@ cer would sort of step through some kind of port@@ al and he wasn &apos;t doing anything different than he had ever done , 1,000 ni@@ ghts before , but everything would ali@@ g@@ n .	时间 似乎 停止 了 ， 舞@@ 者 仿佛 穿越 了 时间 似乎 停止 了 ， 舞@@ 者 仿佛 穿越 了 他 所 做 的 动作 和 之前 的 1000 场 表演 并 没有 什么 不同 但 所有 的 一切 却 奇@@ 迹@@ 般@@ 地 统一 起来 了
and all of a sudden , he would no longer appear to be mer@@ ely human .	刹@@ 那@@ 间 ， 他 不再 是 个 普通 的 凡@@ 人 ， 他 的 生命 从 内部 点@@ 燃 ， 从 心@@ 底 发光
he would be l@@ it from within , and l@@ it from below and all l@@ it up on fire with di@@ vin@@ ity .	刹@@ 那@@ 间 ， 他 不再 是 个 普通 的 凡@@ 人 ， 他 的 生命 从 内部 点@@ 燃 ， 从 心@@ 底 发光 他 被 神圣 之@@ 火 照@@ 耀
and when this happened , back then , people knew it for what it was , you know , they called it by its name .	当时 的 人们 ， 清楚 地 知道 这是 什么 ， 他们 能 叫 出 它 的 名字 当时 的 人们 ， 清楚 地 知道 这是 什么 ， 他们 能 叫 出 它 的 名字
they would put their hands together and they would start to ch@@ ant , &quot; al@@ la@@ h , al@@ la@@ h , al@@ la@@ h , god , god , god . &quot;	他们 会 拍 起 手@@ 来 ， 开始 吟@@ 唱 ： 阿@@ 拉 ， 阿@@ 拉 ， 阿@@ 拉 ， 神 啊 ， 神 啊 ， 神 啊 他们 会 拍 起 手@@ 来 ， 开始 吟@@ 唱 ： 阿@@ 拉 ， 阿@@ 拉 ， 阿@@ 拉 ， 神 啊 ， 神 啊 ， 神 啊
that &apos;s god , you know .	人人 都 知道 ： 那 是 神@@ 迹 显@@ 现
curious histori@@ cal foot@@ note -- when the mo@@ ors inv@@ aded southern sp@@ ain , they took this cu@@ st@@ om with them and the p@@ ron@@ un@@ ci@@ ation changed over the centuries from &quot; al@@ la@@ h , al@@ la@@ h , al@@ la@@ h , &quot; to &quot; o@@ le , o@@ le , o@@ le , &quot; which you still hear in bul@@ l@@ fi@@ ghts and in fla@@ men@@ co dan@@ ces .	有趣 的 野@@ 史 是 ， 当 摩@@ 尔 帝国 入@@ 侵 南 西班牙 时 ， 他们 带@@ 去 了 这 一 习@@ 俗 有趣 的 野@@ 史 是 ， 当 摩@@ 尔 帝国 入@@ 侵 南 西班牙 时 ， 他们 带@@ 去 了 这 一 习@@ 俗 于是 几@@ 世纪 来 ， 颂@@ 词 的 发@@ 音 渐渐 改变 ， 从 “ 阿@@ 拉 , 阿@@ 拉 ” 变成 “ 欧 嘞 , 欧 嘞 ” 于是 几@@ 世纪 来 ， 颂@@ 词 的 发@@ 音 渐渐 改变 ， 从 “ 阿@@ 拉 , 阿@@ 拉 ” 变成 “ 欧 嘞 , 欧 嘞 ” 如今 你 仍 能 在 斗@@ 牛 比赛 和 弗@@ 拉 明@@ 戈@@ 舞 中 听到 这一 喝@@ 彩@@ 声
in sp@@ ain , when a perfor@@ mer has done something impossible and magic , &quot; al@@ la@@ h , o@@ le , o@@ le , al@@ la@@ h , mag@@ nific@@ ent , bra@@ v@@ o , &quot; in@@ com@@ pre@@ hen@@ sible , there it is -- a gli@@ mp@@ se of god .	在 西班牙 ， 当 一个 表@@ 演@@ 者 完成 了 某种 不可思议 的 神奇 之@@ 举 时 人们 就 会 喝@@ 彩 ： “ 阿@@ 拉 ， 欧 嘞 ， 欧 嘞 ， 阿@@ 拉 ， 真 伟大 ， 太棒了 ， 不可思议 ” 那 就是 神@@ 迹 显@@ 现
which is great , because we need that .	这种 方式 很 好 ， 因为 这 正是 我们 需要 的
but , the tri@@ cky bit comes the next morning , for the dan@@ cer himself , when he wa@@ kes up and disco@@ vers that it &apos;s tu@@ es@@ day at 11 a.@@ m. , and he &apos;s no longer a gli@@ mp@@ se of god .	对 艺术家 来说 ， 最 棘@@ 手 的 是 第二天 早上 ， 舞@@ 者 悠@@ 悠 转@@ 醒 对 艺术家 来说 ， 最 棘@@ 手 的 是 第二天 早上 ， 舞@@ 者 悠@@ 悠 转@@ 醒 发现 已经 是 周@@ 二 上@@ 午 11 点 了 ， 他 不再 是 神@@ 迹 的 显@@ 现
he &apos;s just an aging mor@@ tal with really bad kne@@ es , and maybe he &apos;s never going to as@@ c@@ end to that height again .	而 只是 那个 腰@@ 腿 不好 ， 终@@ 将 老@@ 去 的 凡@@ 人 而且 ， 他 或许 再也 无法 达到 昨@@ 晚 那样 的 高度 了
and maybe nobody will ever ch@@ ant god &apos;s name again as he sp@@ ins , and what is he then to do with the rest of his life ?	也许 再@@ 也@@ 不会 有人 在 他 跳舞 时 喝@@ 彩 神@@ 迹 显@@ 现 他 该 如何 自@@ 处 呢 ？
this is hard .	这 是 个 很 棘@@ 手 的 问题 ， 也 是 创作 生涯 中 最 痛苦 的 自我 认知 之一
this is one of the most painful re@@ con@@ ci@@ li@@ ations to make in a creative life .	这 是 个 很 棘@@ 手 的 问题 ， 也 是 创作 生涯 中 最 痛苦 的 自我 认知 之一 这 是 个 很 棘@@ 手 的 问题 ， 也 是 创作 生涯 中 最 痛苦 的 自我 认知 之一
but maybe it doesn &apos;t have to be quite so full of an@@ gu@@ ish if you never happened to believe , in the first place , that the most extraordinary aspects of your being came from you .	但 也许 , 我们 原本 无@@ 需 如此 痛苦 如果 你 本来 就 从 不@@ 曾 认为 ， 那 无@@ 与@@ 伦@@ 比 的 艺术@@ 作品 完全 来源于 你 如果 你 本来 就 从 不@@ 曾 认为 ， 那 无@@ 与@@ 伦@@ 比 的 艺术@@ 作品 完全 来源于 你
but maybe if you just believed that they were on lo@@ an to you from some un@@ imagin@@ able source for some ex@@ qu@@ is@@ ite portion of your life to be passed along when you &apos;re finished , with somebody else .	如果 你 认为 它们 是 某种 神奇 的 存在 ， 只是 暂@@ 时 借 你 一@@ 用 ， 给 你 带来 精@@ 美@@ 绝@@ 伦 的 作品 如果 你 认为 它们 是 某种 神奇 的 存在 ， 只是 暂@@ 时 借 你 一@@ 用 ， 给 你 带来 精@@ 美@@ 绝@@ 伦 的 作品 在 你 完成 作品 后 ， 继续 传递 给 其他人
and , you know , if we think about it this way it starts to change everything .	如果 我们 这样 看待 这一 问题 ， 一切 就 都 改变 了
this is how i &apos;ve started to think , and this is certainly how i &apos;ve been thinking in the last few months as i &apos;ve been working on the book that will soon be published , as the danger@@ ously , frigh@@ ten@@ ingly over@@ -@@ anticip@@ ated follow up to my fre@@ ak@@ ish success .	在 过去 的 几个 月 中 ， 我 开始 以 这种 方式 看待 这一 问题 在 过去 的 几个 月 中 ， 我 开始 以 这种 方式 看待 这一 问题 同时 从事 着 我 下 一 本书 的 写作 那@@ 本 危险 的 ， 骇@@ 人 的 ， 被 过度 预期 的 ， 继 我 的 畅@@ 销 大@@ 作 之后 的 作品 那@@ 本 危险 的 ， 骇@@ 人 的 ， 被 过度 预期 的 ， 继 我 的 畅@@ 销 大@@ 作 之后 的 作品
and what i have to , sort of keep telling myself when i get really psy@@ ched out about that , is , don &apos;t be afraid .	而 我 需要 做 的 ， 就是 不断 告诉 自己 ， 尤其 是 在 我 忧@@ 郁 焦@@ 躁 的 时候 ： 而 我 需要 做 的 ， 就是 不断 告诉 自己 ， 尤其 是 在 我 忧@@ 郁 焦@@ 躁 的 时候 ： “ 不要 害怕 ， 不要 气@@ 馁 ， 只 需 做好 你 的 那 部分 工作 ”
don &apos;t be da@@ un@@ ted .	“ 不要 害怕 ， 不要 气@@ 馁 ， 只 需 做好 你 的 那 部分 工作 ”
just do your job .	“ 不要 害怕 ， 不要 气@@ 馁 ， 只 需 做好 你 的 那 部分 工作 ”
continue to show up for your piece of it , whatever that might be .	坚@@ 守 在 你 的 岗@@ 位 上 ， 无论 你 的 岗@@ 位 是 什么 ： 如果 你 是 舞@@ 者 ， 那 就 跳舞
if your job is to dance , do your dance .	坚@@ 守 在 你 的 岗@@ 位 上 ， 无论 你 的 岗@@ 位 是 什么 ： 如果 你 是 舞@@ 者 ， 那 就 跳舞
if the div@@ ine , co@@ cke@@ yed genius as@@ signed to your case deci@@ des to let some sort of wonder@@ ment be gli@@ mp@@ sed , for just one moment through your effor@@ ts , then &quot; o@@ le ! &quot;	如果 那个 属于 你 的 ， 神圣 却 又 邪@@ 门 的 精@@ 灵 决定 通过 你 让 神@@ 迹 显@@ 现 ， 哪怕 只是 短@@ 短 一@@ 瞬 如果 那个 属于 你 的 ， 神圣 却 又 邪@@ 门 的 精@@ 灵 决定 通过 你 让 神@@ 迹 显@@ 现 ， 哪怕 只是 短@@ 短 一@@ 瞬 那么 ， 让 我们 喝@@ 彩 ： 欧 嘞 ！
and if not , do your dance any@@ how .	如果 没有 ， 那 就 请 继续 跳舞 ， 坚@@ 守 你 的 岗@@ 位 ， 我 依然 为 你 喝@@ 彩 ： 欧 嘞 ！
and &quot; o@@ le ! &quot; to you , non@@ e@@ theless .	如果 没有 ， 那 就 请 继续 跳舞 ， 坚@@ 守 你 的 岗@@ 位 ， 我 依然 为 你 喝@@ 彩 ： 欧 嘞 ！
i believe this and i feel that we must teach it .	我 坚信 我们 必须 传@@ 授 这一 理念
&quot; o@@ le ! &quot; to you , non@@ e@@ theless , just for having the she@@ er human love and stu@@ b@@ bor@@ n@@ ness to keep showing up .	只要 你 出于 热爱 与 执@@ 着 ， 坚@@ 守@@ 岗@@ 位 ， 那 你 就 值得 喝@@ 彩 ： 欧 嘞 ！ 只要 你 出于 热爱 与 执@@ 着 ， 坚@@ 守@@ 岗@@ 位 ， 那 你 就 值得 喝@@ 彩 ： 欧 嘞 ！ 只要 你 出于 热爱 与 执@@ 着 ， 坚@@ 守@@ 岗@@ 位 ， 那 你 就 值得 喝@@ 彩 ： 欧 嘞 ！
thank you .	谢谢
thank you .	谢谢 谢谢
o@@ le !	欧 嘞 ！
last year i showed these two slides so that demonstr@@ ate that the arctic ice cap , which for most of the last three million years has been the size of the lower 48 states , has sh@@ run@@ k by 40 percent .	去年 我 给 各位 展示 了 两个 关于 北@@ 极@@ 冰 帽 的 演示 在 过去 三@@ 百@@ 万年 中 其 面积 由 相当于 美国 南@@ 方 48 州 面积 总@@ 和 缩@@ 减 了 4@@ 0%
but this underst@@ ates the seri@@ ousness of this particular problem because it doesn &apos;t show the th@@ ic@@ kness of the ice .	但 这些 没 能 完全 说明 这个 问题 的 严@@ 重@@ 性 因为 这 没有 表示 出 冰@@ 帽 的 厚@@ 度
the arctic ice cap is , in a sense , the be@@ ating heart of the global climate system .	感觉 上 ， 北@@ 极@@ 冰 帽 就 好@@ 象 全球 气候@@ 系统 中 跳@@ 动 的 心脏
it exp@@ ands in winter and contrac@@ ts in summer .	冬天 心脏 舒@@ 张 ， 夏天 心脏 收@@ 缩
the next slide i show you will be a ra@@ pid fa@@ st-@@ forward of what &apos;s happened over the last 25 years .	下面 我要 展示 的 是 在 过去 25 年里 的 极@@ 剧 变化
the perman@@ ent ice is mar@@ ked in red .	红色 的 是 永 冻@@ 冰
as you see , it exp@@ ands to the dark blue -- that &apos;s the an@@ nu@@ al ice in winter , and it contrac@@ ts in summer .	你 看 ， 它 正在 变成 深@@ 蓝色 这是 每年 冬天 形成 的 年@@ 度 冰 在 夏天 永 冻@@ 冰 收@@ 缩
the so-called perman@@ ent ice , five years old or older , you can see is almost like blood , sp@@ il@@ ling out of the body here .	所谓 的 “ 永@@ 冻 ” ， 是 指 形成 五年 或 更 久 的 冰 你 看 ， 这 也 像 血液 一样 输@@ 送到 身体 各 部位
in 25 years it &apos;s gone from this , to this .	在 25 年 的 时间 里 ， 它 从 这里 ， 到 了 这里
this is a problem because the warming he@@ ats up the frozen ground around the arctic ocean , where there is a massive amount of frozen carbon which , when it th@@ a@@ ws , is turned into me@@ than@@ e by microbes .	值@@ 得@@ 注意 的 是 温@@ 室@@ 效应 使得 北@@ 冰@@ 洋 周围 的 冻@@ 土@@ 层 受@@ 热 而 这里 有 大量 被 冻 封 的 碳 （ 干@@ 冰 ） 解@@ 冻 时 ， 微生物 降@@ 解 碳 形成 甲@@ 烷
compared to the total amount of global warming pollution in the atmosphere , that amount could double if we cross this ti@@ pping point .	如果 突破 顶@@ 点 ， 温室 气体 排放量 将 是 现有 大气层 中 的 全球 温室 污染 总@@ 量
already in some sh@@ allow la@@ kes in al@@ as@@ ka , me@@ than@@ e is ac@@ tively bu@@ bb@@ ling up out of the water .	在 阿拉@@ 斯@@ 加 的 一些 浅 湖@@ 里 已经 可以 看到 水中 探@@ 头 的 沼@@ 气 泡
professor k@@ ate@@ y wal@@ ter from the university of al@@ as@@ ka went out with another team to another sh@@ allow lake last winter .	去年 冬天 ， university of al@@ as@@ ka 的 k@@ ate@@ y wal@@ ter 教授 结@@ 队 去 了 一个 浅@@ 湖
who@@ a !	哇
she &apos;s okay . the question is whether we will be .	她 很 好 ， 我们 怎么样 呢 ？
and one reason is , this enormous heat sin@@ k he@@ ats up green@@ land from the north .	有 一个 原因 ， 北@@ 方 沉@@ 积 的 大量 热@@ 能 加@@ 热 了 格@@ 陵@@ 兰@@ 岛
this is an an@@ nu@@ al mel@@ ting river .	这是 一条 每年 融@@ 化 的 河
but the volu@@ mes are much larger than ever .	但 流@@ 量 却 比 往@@ 年 都 要 大
this is the k@@ an@@ ger@@ l@@ us@@ su@@ a@@ q river in sou@@ th@@ west green@@ land .	这是 格@@ 陵@@ 兰@@ 岛 西@@ 南 的 k@@ an@@ ger@@ l@@ us@@ su@@ a@@ q 河
if you want to know how sea level ri@@ ses from land@@ -@@ base ice mel@@ ting this is where it re@@ aches the sea .	如果 你 想 了解 陆地 上 的 冰@@ 块 融@@ 化 如何 使得 海@@ 平面 上升 这里 就是 它 的 入@@ 海@@ 口
these flo@@ ws are increasing very rapidly .	这里 的 流@@ 量 正在 急@@ 速 上升
at the other end of the planet , ant@@ arc@@ tica the largest mass of ice on the planet .	南@@ 极 ， 地球 的 另一@@ 端 这个 行星 上 最大 的 冰@@ 块
last month scientists re@@ ported the entire continent is now in negative ice balance .	上@@ 个月 ， 科学家 报告 整个 大@@ 洲 正 处于 冰@@ 量 减少 的 阶段
and west ant@@ arc@@ tica cro@@ pped up on top some under@@ -@@ sea islands , is particularly ra@@ pid in its mel@@ ting .	在 南@@ 极@@ 洲 的 西部 突然 发现 几个 低@@ 于 海@@ 平面 的 岛@@ 屿 正在 加速 融@@ 化
that &apos;s equal to 20 feet of sea level , as is green@@ land .	这 相当于 海@@ 平面 上 20 英尺 ， 和 格@@ 陵@@ 兰@@ 岛 一样
in the hi@@ mal@@ ay@@ as , the third largest mass of ice : at the top you see new la@@ kes , which a few years ago were gl@@ aci@@ ers .	在 hi@@ mal@@ ay@@ as , 第三 大 冰@@ 块 在 顶@@ 部 你 可以 看到 新 的 湖@@ 泊 ， 而 几年 前 ， 这 只是 冰@@ 河
40 percent of all the people in the world get half of their drinking water from that mel@@ ting flow .	全球 4@@ 0% 从 其 融@@ 水 中 获得 一半 的 饮@@ 用@@ 水
in the and@@ es , this gl@@ ac@@ ier is the source of drinking water for this city .	在 安@@ 第@@ 斯@@ 山脉 , 这 条 冰@@ 河 是 这座 城市 的 饮@@ 用@@ 水 源
the flo@@ ws have increased .	流@@ 量 正在 增加
but when they go away , so does much of the drinking water .	但 当 它们 消失 时 ， 我们 也 将 失去 饮@@ 用@@ 水
in california there has been a 40 percent decline in the si@@ er@@ ra s@@ now@@ pack .	在 california , si@@ er@@ ra 的 积@@ 雪 每年 减少 4@@ 0%
this is h@@ itting the reser@@ vo@@ irs .	对于 蓄@@ 水 而言 ， 这是 一个 打击
and the predi@@ ctions , as you &apos;ve read , are serious .	而且 如 你 看到 的 ， 预@@ 计 是 非常 严重 的
this dr@@ ying around the world has lead to a dramatic increase in fi@@ res .	全球 的 干@@ 燥 化 正在 导致 火@@ 灾 数量 急@@ 剧 增加
and the disa@@ sters around the world have been increasing at an absolutely extraordinary and un@@ prece@@ den@@ ted rate .	而 全世界 的 灾@@ 害 数量 也 正@@ 以 绝对 显著 的 空@@ 前 的 速度 增加
four times as many in the last 30 years as in the previous 75 .	在 过去 三@@ 十年 内 ， 灾@@ 害 总@@ 数 达到 了 更 早 七@@ 十@@ 五年 总@@ 数 的 四@@ 倍
this is a completely un@@ sustainable pattern .	这是 一种 完全 不可 持续 的 模式
if you look at in the context of history you can see what this is doing .	如果 看 下 历史 你 可以 看到 发生 了 些 什么
in the last five years we &apos;ve added 70 million tons of co2 every 24 hours -- 25 million tons every day to the oceans .	在 过去 的 五年 我们 每天 增加 七@@ 千 万@@ 吨 二氧化碳 向 海洋 排放 两@@ 千@@ 五@@ 百 万@@ 吨 二氧化碳
look carefully at the area of the eastern pacific , from the ameri@@ ca@@ s , exten@@ ding we@@ st@@ ward , and on either side of the indian sub@@ continent , where there is a radical de@@ ple@@ tion of oxygen in the oceans .	注意 看@@ 下@@ 东 太平洋 区域 从 美洲 向@@ 西 在 印度 次@@ 大陆 的 两@@ 边 海洋 含@@ 氧@@ 量 急@@ 剧 减少
the biggest single cause of global warming , along with de@@ fore@@ station , which is 20 percent of it , is the burning of fossil fuels .	温@@ 室@@ 效应 最大 的 原因 ， 除了 森林 破坏 占 20% 外 是 燃烧 石油 燃料
oil is a problem , and coal is the most serious problem .	石油 很 重要 ， 煤@@ 炭 最为 紧@@ 要
the united states is one of the two largest em@@ it@@ ters , along with china .	美国 正 成为 全球 最大 的 两个 排放 国 之一 ， 和 中国 一起
and the pro@@ pos@@ al has been to build a lot more coal plants .	解决方案 曾经 是 建造 一个 使用 更 多 煤@@ 碳 的 星球
but we &apos;re beginning to see a sea change .	但 我们 已经 开始 看到 海洋 的 变化 了
here are the ones that have been can@@ cel@@ led in the last few years with some green alter@@ na@@ tives pro@@ posed .	这里 是 近@@ 年 已经 取@@ 消 的 一些 以及 一些 新 的 绿色 替代 方案
however there is a political battle in our country .	（ 掌声 ） 但是 ， 在 我们 国家 有 一场 政治 战争
and the coal industries and the oil industries spent a quarter of a billion dollars in the last cal@@ en@@ da@@ r year pro@@ mot@@ ing clean coal , which is an oxy@@ mor@@ on .	而 煤@@ 碳 和 石@@ 油@@ 工业 在 去年 花费 了 两@@ 千@@ 五@@ 百 万美元 来 提@@ 倡 清洁 煤@@ 炭 这@@ 太 矛盾 了
that image remin@@ ded me of something .	那个 画面 让 我 想起 了 什么
around christmas , in my home in ten@@ nes@@ see , a billion gall@@ ons of coal slu@@ dge was sp@@ il@@ led .	圣@@ 诞 前@@ 后 ， 在 我 的 家乡 田@@ 纳@@ 西 挖@@ 出 了 几@@ 十亿 升 的 煤 淤@@ 泥
you probably saw it on the news .	可能 你 在 新闻 上 看过
this , all over the country , is the second largest waste stream in america .	这里 ， 是 全@@ 美 第二 大 的 废@@ 水 排放
this happened around christmas .	这 发生 于 圣@@ 诞 前@@ 后
one of the coal industry &apos;s ads around christmas was this one .	有 一@@ 则 这样 的 煤@@ 碳 行业 广告
fro@@ sty the coal man is a j@@ ol@@ ly , happy soul .	煤@@ 炭 酷 先生 是 高兴 和 快乐 的 化@@ 身
he &apos;s abun@@ d@@ ant here in america , and he helps our economy grow .	在 美国 你 可以 见到 他 富@@ 饶 多@@ 产 他 还 帮助 我们 发展 经济
fro@@ sty the coal man is getting clean@@ er everyday .	煤@@ 炭 酷 先生 每天 都 在 变得 更 干净
he &apos;s affor@@ dable and ad@@ or@@ able , and workers keep their pay .	他 可爱 实@@ 惠 ， 为 工人 们 带来 工作 机会
this is the source of much of the coal in west virg@@ in@@ ia .	这里 是 west virg@@ in@@ ia ， 许多 煤@@ 炭 的 原@@ 产@@ 地
the largest moun@@ tain@@ top min@@ er is the head of mas@@ sey coal .	最大 的 山@@ 顶 采@@ 矿 是 head of mas@@ sey coal
let me be clear about it . al gore , nan@@ cy pe@@ lo@@ s@@ i , har@@ ry re@@ id , they don &apos;t know what they &apos;re talking about .	让 我 来 澄@@ 清@@ 事实 （ 这个 老@@ 兄 是 马@@ 塞 能源 公司 总@@ 裁@@ 兼 总@@ 经@@ 理 ， 马@@ 赛 能源 公司 被 卷@@ 入 一@@ 连@@ 串 的 法律 与 环境 的 争议 当中 ， 争议 主要 存在 于 其 开采 过程 中 没有 采取@@ 相应 的 防@@ 污@@ 措施 ） al core , nan@@ cy pe@@ lo@@ s@@ i （ 现@@ 任 众@@ 议@@ 院 议@@ 长 ） , har@@ ry re@@ id （ 众@@ 议@@ 院 能源 和 商业 委员会 主@@ 席 ） （ 这 两个 人 都 致力于 通过 国会 推动 一项 综@@ 合@@ 性 的 能源 与 气候 议@@ 案 ） ， 这@@ 帮 家伙 完全 不 懂得 他们 在 讲@@ 些 什么
so the al@@ li@@ ance for climate protection has launched two campa@@ ig@@ ns .	所以 气候 保护 联盟 （ 戈@@ 尔 是 成立 人 之一 及 现@@ 任 主@@ 席 ） 开展 了 两个 项目
this is one of them , part of one of them .	这是 其中 的 一个 ， 其中 一个 的 一部分
at co@@ al@@ er@@ gy we view climate change as a very serious threat to our business .	在 co@@ al@@ er@@ gy ， 我们 非常 严肃 地 对待 气候变化 对 我们 的 事业 威胁
that &apos;s why we &apos;ve made it our primary goal to spend a large sum of money on an adverti@@ sing effort to help bring out and compli@@ cate the truth about coal .	这是 为什么 我们 花费 大量 金钱 制定 我们 的 最初 目标 努力 挖掘 并 阐@@ 释 煤@@ 炭 的 真相
the fact is , coal isn &apos;t dirty .	事实上 ， 煤@@ 炭 并 不 肮@@ 脏
we think it &apos;s clean -- sm@@ el@@ ls good , too .	我们 认为 ， 它 是 干净 的 好@@ 闻 的
so don &apos;t worry about climate change .	因此 ， 不必 为 全球 变暖 而 担心
leave that up to us .	让 我们 来 搞@@ 定 吧
clean coal -- you &apos;ve heard a lot about it .	清洁 煤@@ 炭 ， 你 已经 听过 关于 它 的 许多
so let &apos;s take a tour of this state@@ -of-@@ the-@@ art clean coal fac@@ ility .	所以 ， 让 我们 去 看看 如同 艺术 一般 的 清洁 煤@@ 炭 工厂 吧
amazing ! the mach@@ in@@ ery is kind of lou@@ d .	壮@@ 观 ！ 机器 有些 喧@@ 哗
but that &apos;s the sound of clean coal technology .	但 这 是 清洁 煤@@ 炭 技术 的 声音
and while burning coal is one of the leading causes of global warming , the remarkable clean coal technology you see here changes everything .	虽然 烧@@ 煤 是 导致 全球 变暖 的 主要 原因 之一 你 在 这里 所 见到 的 令人 折@@ 服 的 清洁 煤@@ 炭 技术 改变 了 一切
take a good long look : this is today &apos;s clean coal technology .	好好 看看 吧 ！ 这 就是 如今 的 清洁 煤@@ 炭 技术
finally , the positive alternative me@@ shes with our economic challenge and our national security challenge .	最后 是 这个 正面 的 方案 可以 应对 经济 挑战 和 国家 安全 挑战
america is in crisis -- the economy , national security , the climate crisis .	美国 正 处于 危机 经济 的 、 国家 安全 的 、 气候 的 危机
the th@@ read that links them all : our addi@@ ction to carbon based fuels , like dirty coal and foreign oil .	将 这些 危机 都 串 在 一起 的 是 我们 对于 基于 碳 的 石油 产品 的 依赖 譬@@ 如 肮@@ 脏 的 煤@@ 炭 和 进@@ 口 的 石油
but now there is a bo@@ ld new solution to get us out of this mess .	但 现在 ， 有 一种 全新 的 解决 这些 难题 的 方案
re@@ power america with 100 percent clean electricity within 10 years .	re@@ power america 用 百分@@ 百 清洁 的 电力 用 十年 的 时间
a plan to put america back to work , make us more secure , and help stop global warming .	让 美国 人 全新 获得 工作 让 我们 生活 得 更 安全 ， 并且 让 地球 不 在 变暖
finally , a solution that &apos;s big enough to solve our problems .	最终 ， 一个 足够 庞大 的 方案 来 解决 我们 的 问题
re@@ power america . find out more .	re@@ power america ， 了解 更 多
this is the last one .	最后 一个
it &apos;s about re@@ power@@ ing america .	这是 关于 re@@ power america 的
one of the fa@@ ste@@ st ways to cut our depen@@ dence on old dirty fuels that are killing our planet .	陈@@ 旧 的 肮@@ 脏 石油 正在 谋@@ 杀 我们 的 星球 这 是 让 我们 减少 对 其 依赖 的 最快 方式
future &apos;s over here . wind , sun , a new energy grid .	未来 就 在 这里 。 风@@ 力 、 太阳能 、 新 的 能源 网络
new invest@@ ments to create high-@@ paying jobs .	新 的 投资 创造 更 的 报@@ 酬 丰@@ 厚 的 工作
re@@ power america . it &apos;s time to get real .	re@@ power america 。 是 时候 梦@@ 想@@ 成@@ 真 了 ！
there is an old african pro@@ ver@@ b that says , &quot; if you want to go quickly , go alone .	有 一条 古老 的 非洲 谚@@ 语 如果 想要 走@@ 得@@ 快 ， 独立 前@@ 行
if you want to go far , go together . &quot;	如果 想要 走 得 远 ， 结@@ 伴 前@@ 行
we need to go far , quickly .	我们 需要 的 是 走 得 远 ， 而且 快
thank you very much .	非常感谢
i want to start out by asking you to think back to when you were a kid , playing with blocks .	首先 ， 我 想 请 大家 回忆 一下 你们 在 孩@@ 提@@ 时代 玩@@ 过 的 积@@ 木 。
as you figured out how to reach out and gra@@ sp , pick them up and move them around , you were actually learning how to think and solve problems by understanding and mani@@ pul@@ ating spa@@ tial relationships .	当 你 构@@ 思 着 怎么 去 搭建 积@@ 木 并且 去 动@@ 手 操作 的 时候 ， 其实 是 你 正在 学习 怎样 思考 和 解决问题 。 这@@ 即 是 对 物体 的 空@@ 间@@ 结构 的 理解 和 感知 。
spa@@ tial reason@@ ing is deeply connected to how we understand a lot of the world around us .	理解 物体 的 空@@ 间@@ 结构 非常 有@@ 助@@ 于 我们 对 很多 周围 事物 的 学习 。
so , as a computer scientist inspired by this u@@ til@@ ity of our inter@@ actions with physical objects -- along with my ad@@ vi@@ ser pat@@ tie , and my collabor@@ ator je@@ ev@@ an k@@ al@@ ani@@ th@@ i -- i started to wonder -- what if when we used a computer , instead of having this one mouse cur@@ sor that was a like a digital fin@@ ger@@ ti@@ p moving around a flat de@@ sk@@ top , what if we could reach in with both hands and gra@@ sp information physically , ar@@ ran@@ ging it the way we wanted ?	因此 ， 作为 一个 计算机@@ 领域 的 科学家 ， 在 这种 手@@ 动 思考 方式 的 启发 下 ， 以及 在 我 的 导@@ 师 pat@@ tie 和 我 的 合作@@ 伙伴 je@@ ev@@ an k@@ al@@ ani@@ th@@ i 的 帮助 下 ， 我 开始 思考 -- 要是 我们 能 用 一种 新型 计算机 来 代替 鼠标 移动 光@@ 标 ， 就 好比 一种 数@@ 字@@ 化 的 手@@ 指@@ 尖 在 桌@@ 面 移动 -- 那样 会 如何 呢 ？ 要是 我们 能@@ 用 手@@ 来 直接 感知 信息 ， 按 我们 的 思@@ 路 来 组合 信息 -- 那样 会 如何 呢 ？
this question was so compe@@ lling that we decided to explore the answer , by building si@@ f@@ tables .	这样 的 疑问 不断 萦@@ 绕@@ 在 我 的 脑@@ 海@@ 中 ， 于是 我们 决定 去 探@@ 寻 答案 ， 所以 才 有 了 这@@ 款 si@@ f@@ tables 。
in a nu@@ t@@ shell , a si@@ f@@ table is an interactive computer the size of a coo@@ ki@@ e .	简单 地说 ， si@@ f@@ table 是 一@@ 款 互动 计算机 ， 体@@ 积 如 饼@@ 干 般 大小 。
they &apos;re able to be moved around by hand , they can sense each other , they can sense their motion , and they have a screen and a wireless radio .	si@@ f@@ tables 可以 用@@ 手 随意 移动 ， 每@@ 块 si@@ f@@ table 可以 互相 感知 彼此 的 移动 ， 每@@ 块 si@@ f@@ table 还有 显@@ 示@@ 屏 和 无线@@ 电 装置 。
most importantly , they &apos;re physical , so like the blocks , you can move them just by reaching out and gra@@ sp@@ ing .	最 重要 的 是 ， 每@@ 块 si@@ f@@ table 都 是 独立 的 ， 就 像 积@@ 木 一样 ， 可以 随意 搭@@ 配 。
and si@@ f@@ tables are an example of a new ecosystem of tools for mani@@ pul@@ ating digital information .	而且 si@@ f@@ tables 代表 了 一种 新 的 生态系统 -- 即 数@@ 字@@ 化 信息 的 操作 工具 。
and as these tools become more physical , more aware of their motion , aware of each other , and aware of the nu@@ ance of how we move them , we can start to explore some new and fun interaction sty@@ les .	这种 操作 工具 更加 独立 ， 更加 灵@@ 敏 ， 能 彼此 感知 ， 感知 任何 细@@ 微 的 移动 ， 所以 我们 可以 使用 这种 工具 尝试 一些 新 的 有趣 的 互动 。
so , i &apos;m going to start with some simple examples .	现在 ， 我 就 来 演示 一些 简单 的 。
this si@@ f@@ table is con@@ figured to show video , and if i ti@@ lt it in one direction , it &apos;ll roll the video this way ; if i ti@@ lt it the other way it rol@@ ls it backwards .	这块 si@@ f@@ table 有 映@@ 像 配@@ 置 ， 如果 我 把 它 向 一@@ 侧 倾@@ 斜 ， 那么 它 所 显示 的 画面 也 朝 这边 倾@@ 斜 ， 如果 我 把 它 朝 反 方向 倾@@ 斜 ， 那么 图像 也 朝 反 方向 倾@@ 斜 。
and these interactive portra@@ its are aware of each other .	而且 这些 si@@ f@@ tables 能 互相 感知 。
so if i put them next to each other , they get interested .	如果 把 它们 一个 挨 一个 摆@@ 好 ， 有趣 的 现象 就 会 发生 。
if they get surrounded , they notice that too , they might get a little flu@@ ster@@ ed .	如果 把 它们 随意 一堆 ， 他们 也 会 察@@ 觉@@ 到 ， 那 就 会 有点@@ 儿 混乱 。
and they can also sense their motion and ti@@ lt .	它们 还 能 感知 彼此 的 移动 和 倾@@ 斜 。
one of the interesting implications on interaction , we started to realize , was that we could use everyday ge@@ stu@@ res on data , like po@@ uring a color the way we might po@@ ur a liquid .	我们 发现 一个 有趣 的 互动 -- 我们 可以 通过 一些 常@@ 用 的 手@@ 势 和 si@@ f@@ tables 进行 互动 ， 比如 象 倒 液体 那样 把 颜色 从 一块 si@@ f@@ table 倒@@ 入 另 一块 si@@ f@@ table .
so in this case , we &apos;ve got three si@@ f@@ tables con@@ figured to be paint bu@@ ckets and i can use them to po@@ ur color into that central one , where they get mi@@ xed .	我们 来看 这个 演示 ， 这有 三@@ 块 设置 成 油@@ 漆 桶 模式 的 si@@ f@@ tables , 我们 可以 把 这些 桶 里 的 颜色 倒@@ 入 中间 的 那个 ， 把 颜色 混@@ 在 一起 .
if we over@@ shoot , we can po@@ ur a little bit back .	如果 倒 多 了 ， 可以 再 倒@@ 回去 一些 。
there are also some ne@@ at possibilities for education , like language , math and logic games where we want to give people the ability to try things quickly , and view the results immediately .	si@@ f@@ tables 还有 学@@ 习@@ 机 的 功能 ， 可以 用来 学 语言 、 算 算@@ 术 等 -- 我们 希望 通过 这些 功能 让 学习 变得 快@@ 捷 ， 更 快 看到 结果 。
so here i &apos;m -- this is a fi@@ bon@@ ac@@ c@@ i sequence that i &apos;m making with a simple equation program .	这 也 是 我 来 这里 展示 si@@ f@@ tables 的 原因 -- （ 掌声 ） 这 是 我 用 一个 简单 方@@ 程@@ 式 做成 的 斐@@ 波 那@@ 契 数@@ 列 。
here we have a word game that &apos;s kind of like a ma@@ sh@@ -up between sc@@ rab@@ ble and bo@@ ggle .	si@@ f@@ tables 还 可以 玩 拼@@ 字@@ 游戏 -- 一种 sc@@ rab@@ ble 和 bo@@ ggle 混 搭 的 拼@@ 字@@ 游戏 。
basically , in every round you get a random@@ ly as@@ signed letter on each si@@ f@@ table , and as you try to make words it chec@@ ks against a dic@@ tionary .	这种 拼@@ 字@@ 游戏 的 玩@@ 法 大@@ 致 如@@ 下 ， 你 随意 拿 一块 带有 字母 的 si@@ f@@ table , 当 你 把 几@@ 块 带有 字母 的 si@@ f@@ tables 拼@@ 在一起 组成 单词 时 ， si@@ f@@ tables 会 在 字典 里 自动 查@@ 找 单词 。
then , after about 30 seconds , it re@@ shu@@ ff@@ les , and you have a new set of letters and new possibilities to try .	大约 30 秒 后 si@@ f@@ tables 会 自动 根据 正确 的 单词 拼@@ 写 顺序 改变 原来 显示 的 字母 ， 组成 正确 的 单词 ， 你 还 可以 尝试 用 其他 的 字母 拼 出@@ 新 的 单词 。
thank you .	（ 掌声 ） 谢谢 大家 。
so these are some kids that came on a field trip to the media lab , and i managed to get them to try it out , and shoot a video .	（ 掌声 ） 现在 ， 屏幕 上 显示 的 是 一些 孩子 正在 media lab 里 参与 si@@ f@@ tables 的 试@@ 用 体验 ， 我 把 孩子 们 的 体验 过程 拍 了 下来 。
they really loved it .	孩子 们 非常 喜欢 si@@ f@@ tables 。
and , one of the interesting things about this kind of application is that you don &apos;t have to give people many instruc@@ tions .	而且 有趣 的 是 在 玩 这个 拼@@ 字@@ 游戏 的 时候 我们 并不@@ 需要 向 他们 解释 什么 。
all you have to say is , &quot; make words , &quot; and they know exactly what to do .	只要 跟 他们 说 这 是 个 “ 拼@@ 字 ” 游戏 时 ， 他们 就 知道 该 怎么 做 了 。
so here &apos;s another few people trying it out .	现在 屏幕 上 显示 的 是 另 一些 人 在 体验 si@@ f@@ tables 。
that &apos;s our youn@@ gest be@@ ta te@@ ster , down there on the right .	右@@ 下@@ 角 这位 是 年龄 最@@ 小 的 体验 者 。
turns out , all he wanted to do was to st@@ ack the si@@ f@@ tables up .	他 只是 想 把 si@@ f@@ tables 堆 在 一起 。
so to him , they were just blocks .	在 他 看来 ， si@@ f@@ tables 只是 积@@ 木 。
now , this is an interactive cartoon application .	现在 屏幕 上 显示 的 是 一种 动画 功能 的 互动 尝试 。
and we wanted to build a learning tool for language lear@@ ners .	我们 希望 si@@ f@@ tables 能 成为 学习 语言 的 帮@@ 手 。
and this is fe@@ li@@ x , actually .	画面 上 的 这个 孩子 叫 fe@@ li@@ x 。
and he can bring new characters into the scene , just by li@@ fting the si@@ f@@ tables off the table that have that character shown on them .	他 能 把 一些 新@@ 元素 添@@ 加 到 动画 图像 上 ， 他 所 做 的 就是 把 桌@@ 上 的 si@@ f@@ tables 拿 起来 朝@@ 着 动画 图像 投 一下 影 ， 就 可以 把 这些 新@@ 元素 加 到 动画 上 了 。
here , he &apos;s bringing the sun out .	看 ， 他 把 太阳 加上 去 了 。
the sun is rising .	太阳@@ 升 起来 了 。
now he &apos;s brought a trac@@ tor into the scene .	大卫 · 现在 他 把 拖@@ 拉@@ 机 加上 去 了 。
the orange trac@@ tor .	橙@@ 色 的 拖@@ 拉@@ 机 。
good job ! yeah !	做 的 不错 ！
so by sha@@ king the si@@ f@@ tables and putting them next to each other he can make the characters interact -- wo@@ of !	把 si@@ f@@ tables 朝 动画 图像 晃 一下 就 可以 把 新@@ 元素 加 到 画面 上 他 把 新@@ 元素 加上 去 了 -- 狗@@ 吠@@ 声
inven@@ ting his own narrative .	他 在 编@@ 写 属于 他 的 动画 故事 。
hello !	你好 ！
it &apos;s an open-@@ ended story , and he gets to decide how it un@@ fol@@ ds .	这 是 个 开@@ 放@@ 式 结@@ 局 的 故事 ， 他 在 计划 怎样 展开 故@@ 事@@ 情@@ 节 。 .
fly away , cat .	猫 坐 着 热@@ 气球 飞@@ 走 了 。
so , the last example i have time to show you today is a music sequ@@ encing and live performance tool that we &apos;ve built recently , in which si@@ f@@ tables act as sounds like lead , bas@@ s and dru@@ ms .	下面 我要 给 大家 进行 最后 一个 展示 这个 功能 可以 编@@ 排 、 演奏 音乐 是 我们 最近 研发 的 ， si@@ f@@ tables 的 这种 功能 体现 在 声音 方面 ， 能 发出 像 超@@ 载 音 、 贝@@ 斯 及 鼓 的 声音 。
each of these has four different vari@@ ations , you get to choose which one you want to use .	每个 模@@ 块 有 四@@ 档 可 供 调@@ 节 ， 任@@ 君 选择 。
and you can in@@ ject these sounds into a sequence that you can assemb@@ le into the pattern that you want .	你 可以 把 声音 模@@ 块 的 si@@ f@@ table 里 的 声音 加入 编辑 模@@ 块 的 si@@ f@@ table 按 你 喜欢 的 方式 。
and you in@@ ject it by just bu@@ mping up the sound si@@ f@@ table against a sequence si@@ f@@ table .	加入 声音 只 需 把 声音 模@@ 块 靠近 编辑 模@@ 块 。
there are effects that you can control live , like rever@@ b and fil@@ ter .	还有 类似 混@@ 响@@ 器 、 滤@@ 声@@ 器 作用 的 si@@ f@@ table 模@@ 块 。
you att@@ ach it to a particular sound and then ti@@ lt to ad@@ just it .	把 这类 模@@ 块 靠近 声音 模@@ 块 就 可以 调整 声音 了 。
and then , overall effects like temp@@ o and volume that apply to the entire sequence .	接下来 ， 可以 用 控制 总@@ 体 节奏 和 音@@ 量 的 si@@ f@@ table 模@@ 块 靠近 编辑 模@@ 块 的 si@@ f@@ table 来 调整 节奏 和 音@@ 量 。
so let &apos;s have a look .	我们 来看 一下 。
we &apos;ll start by putting a lead into two sequence si@@ f@@ tables , ar@@ range them into a series , ex@@ tend it , add a little more lead .	开始 先 把 超@@ 载 音 注入 两个 编辑 模@@ 块 ， 再 加 一些 超@@ 载 音 。
now i put a bas@@ s line in .	现在 加入 贝@@ 斯 音 。
now i &apos;ll put some per@@ c@@ us@@ sion in .	现在 加入 一些 打@@ 击@@ 乐器 的 声音 。
and now i &apos;ll att@@ ach the fil@@ ter to the dru@@ ms , so i can control the effect live .	现在 把 滤@@ 声 模@@ 块 靠近 鼓@@ 声 模@@ 块 ， 这样 可以 调整 声音 。
i can speed up the whole sequence by til@@ ting the temp@@ o one way or the other .	我来 把 节奏 加@@ 快 些 只 需 把 节奏 模@@ 块 靠近 编辑 模@@ 块 。
and now i &apos;ll att@@ ach the fil@@ ter to the bas@@ s for some more expression .	现在 再 把 滤@@ 声 模@@ 块 靠近 贝@@ 斯 模@@ 块 滤@@ 声 。
i can re@@ ar@@ range the sequence while it plays .	在 音乐@@ 演奏 的 过程 中 还 可以 重新 编@@ 排 。
so i don &apos;t have to plan it out in ad@@ v@@ ance , but i can improvi@@ se , making it longer or shor@@ ter as i go .	所以 并不@@ 需要 提@@ 前 编@@ 排 ， 而是 在 演奏 时 随时 改@@ 编 ， 可@@ 长@@ 可@@ 短 。
and now , finally , i can fa@@ de the whole sequence out using the volume si@@ f@@ table , til@@ ted to the left .	最后 ， 我来 结束 整个 演奏 ， 用 音@@ 量 模@@ 块 靠近 编辑 模@@ 块 ， 用 左边 这个 档 。
thank you .	（ 掌声 ） 谢谢 大家 。
so , as you can see , my passion is for making new human@@ -@@ computer inter@@ faces that are a better match to the ways our brains and bodies work .	正如 大家 看到 的 ， 我 的 理想 就是 研发 一@@ 款 新型 的 能够 人@@ 机 互动 的 媒介 更好 地 配@@ 合 人体 大脑 的 运作 。
and today , i had time to show you one point in this new design space , and a few of the possibilities that we &apos;re working to bring out of the laboratory .	今天 ， 我 在 这 给 大家 展示 了 si@@ f@@ table ， 我们 的 后@@ 续 研究 正在 实验室 中 进行 。
so the thought i want to leave you with is that we &apos;re on the c@@ us@@ p of this new generation of tools for interacting with digital media that are going to bring information into our world on our terms .	我 想 跟 大家 交流 的 想法 就是 我们 在 研发 新@@ 一代 尖@@ 端@@ 科技 产品 -- 可以 和 数字 媒体 接@@ 轨 的 科技 产品 ， 它 将 给 世界 带来 变化 这样 的 革新 在 我们 这 一代 就 会 看到 。
thank you very much .	非常感谢 大家 。
i look forward to talking with all of you .	我 期待 着 和 大家 共同 探讨 。
one day , los angeles times colum@@ ni@@ st steve lo@@ pe@@ z was walking along the streets of down@@ town los angeles when he heard beautiful music .	有 一天 ， 洛杉矶 时报 的 专@@ 栏@@ 作家 steve lo@@ pe@@ z 走 在 洛杉矶 大街 上 听到 一@@ 曲 美妙 的 乐@@ 曲
and the source was a man , an afri@@ can@@ -@@ american man , char@@ ming , ru@@ gged , home@@ less , playing a viol@@ in that only had two str@@ ings .	音乐 是从 一个 男人 一个 非@@ 裔 男人 一个 颇 有 魅力 ， 粗@@ 旷 的 流@@ 浪@@ 汉 用 一把 只 剩下 两@@ 根 弦 的 小@@ 提@@ 琴 在 演奏
and i &apos;m telling a story that many of you know , because steve &apos;s colum@@ ns became the basis for a book , which was turned into a movie , with robert dow@@ ney j@@ r@@ . acting as steve lo@@ pe@@ z , and jam@@ ie fo@@ x@@ x as na@@ than@@ iel an@@ th@@ ony a@@ yers , the ju@@ il@@ li@@ ar@@ d-@@ trained double bas@@ si@@ st whose promi@@ sing career was cut short by a tra@@ gic aff@@ li@@ ction with par@@ an@@ o@@ id sch@@ iz@@ op@@ hren@@ ia .	我 现在 要 讲 的 这个 故事 你们 很多 人 已经 知道 了 因为 steve 的 专@@ 栏 后来 成 了 一本 书 的 基础 ， 然后 又 被 拍@@ 成@@ 电影 其中 robert dow@@ ney j@@ r 扮演 steve lo@@ pe@@ z jam@@ ie fo@@ x@@ x 扮演 了 na@@ than@@ iel an@@ th@@ ony a@@ yer 他 原本 是 茱@@ 莉@@ 亚 音乐@@ 学院 培训 的 双@@ 重 贝@@ 斯@@ 手 不@@ 料 他 的 职业@@ 生涯 却 因为 患@@ 上 偏@@ 执 型 精神@@ 分@@ 裂@@ 症 而 不幸 中@@ 断
na@@ than@@ iel dropped out of ju@@ il@@ li@@ ard , he suff@@ ered a complete break@@ down , and 30 years later he was living home@@ less on the streets of sk@@ id row in down@@ town los angeles .	na@@ than@@ iel 从 茱@@ 莉@@ 亚 音乐@@ 学院 辍@@ 学 ， 他 完全 崩溃 了 30 年 后 的 他 流@@ 落 在 洛杉矶 sk@@ id row 大街 上 无@@ 家@@ 可@@ 归
i encourage all of you to read steve &apos;s book or to watch the movie to understand not only the beautiful b@@ ond that formed between these two men , but how music helped shape that b@@ ond , and ultimately was instru@@ mental -- if you &apos;ll par@@ don the pu@@ n -- in helping na@@ than@@ iel get off the streets .	我 鼓励 大家 都 去 看看 steve 的 书 ， 或者 看看 电影 不光 是 去 理解 这 两个 男人 之间 建立 的 美好 的 纽@@ 带 而且 也 看看 音乐 是 如果 帮助 建立 这种 纽@@ 带 的 而 那 是 最终 改变 na@@ than@@ iel 流@@ 浪 生活 的 最 有用 的 工具
i met mr. a@@ yers in 2008 , two years ago , at wal@@ t dis@@ ney concer@@ t hall .	我 和 a@@ yers 先生 在 2008 年 相@@ 见 那 是 两年 前 在 迪@@ 斯@@ 尼 音乐@@ 厅
he had just heard a performance of bee@@ tho@@ ven &apos;s first and fourth sym@@ ph@@ on@@ ies , and came back@@ stage and introduced himself .	他 才 听 了 贝@@ 多@@ 芬 第一 ， 第@@ 四 交@@ 响@@ 乐 到 后@@ 天 来 自我@@ 介绍
he was speaking in a very jo@@ vi@@ al and gre@@ g@@ ari@@ ous way about yo@@ -@@ yo ma and hil@@ lar@@ y clin@@ ton and how the do@@ d@@ gers were never going to make the world series , all because of the tre@@ ach@@ er@@ ous first viol@@ in pas@@ sage work in the last movement of bee@@ tho@@ ven &apos;s fourth sym@@ ph@@ ony .	他 说话 很 愉快 ， 很 合@@ 群 提到 了 马@@ 友@@ 友 和 希@@ 拉@@ 里 . 克@@ 林@@ 顿 道@@ 奇 队 不 可能 进入 世界 联@@ 赛 而 这 都 是因为 最后 一刻 贝@@ 多@@ 芬 第@@ 四 交@@ 响@@ 乐 中 开始 的 那@@ 段 变@@ 幻@@ 莫@@ 测 的 小@@ 提@@ 琴 演奏 起 的 作用
and we got talking about music , and i got an email from steve a few days later saying that na@@ than@@ iel was interested in a viol@@ in lesson with me .	我们 谈 了 一会儿 音乐 。 几天 后 我 收到 steve 的 来@@ 信 告诉 我 na@@ than@@ iel 有 兴趣 跟 我 说@@ 学 小@@ 提@@ 琴
now , i should mention that na@@ than@@ iel ref@@ uses treatment because when he was treated it was with shock therapy and th@@ or@@ a@@ z@@ ine and hand@@ cu@@ ff@@ s , and that s@@ car has stayed with him for his entire life .	我 应该 提 一下 的 是 na@@ than@@ iel 拒绝 治疗 因为 当@@ 初 他 接受 的 是 电@@ 击 疗法 用 的 是 镇@@ 静@@ 剂 和 手@@ 铐 那些 伤@@ 疤 从@@ 此 留在 了 他 的 生活 中
but as a result now , he is pr@@ one to these sch@@ iz@@ op@@ hren@@ ic ep@@ iso@@ des , the worst of which can mani@@ fe@@ st themselves as him explo@@ ding and then disappe@@ aring for days , wan@@ dering the streets of sk@@ id row , exposed to its hor@@ rors , with the tor@@ ment of his own mind un@@ lea@@ shed upon him .	结果 呢 ， 他 的 精神@@ 分@@ 裂@@ 症 现在 变得 更 容易 发@@ 作 最 糟糕 的 表现 是 他 发@@ 作 后 会 消失 几天 在 sk@@ id row 大街 上 流@@ 浪 暴@@ 露 着 内心 的 恐惧 ， 让 心灵 的 煎@@ 熬 在 身上 释放
and na@@ than@@ iel was in such a state of ag@@ itation when we started our first lesson at wal@@ t dis@@ ney concer@@ t hall -- he had a kind of man@@ ic gl@@ int in his eyes , he was lost .	na@@ than@@ iel 当@@ 初 就是 处在 这样 的 一种 状态 下 我们 在 迪@@ 斯@@ 尼 音乐@@ 厅 开始 了 第一@@ 课 的 时候 他 的 目@@ 光 中 夹@@ 杂@@ 着 狂@@ 躁 他 是 一个 迷@@ 失 了 方向 的 人
and he was talking about invisible demon@@ s and smoke , and how someone was po@@ is@@ on@@ ing him in his sleep .	他 提到 了 无@@ 形 的 恶@@ 魔 和 烟@@ 雾 有人 怎样 在 他 睡@@ 觉@@ 时 给 他 下@@ 毒
and i was afraid , not for myself , but i was afraid that i was going to lose him , that he was going to sin@@ k into one of his states , and that i would ru@@ in his relationship with the viol@@ in if i started talking about sc@@ ales and ar@@ pe@@ g@@ gi@@ os and other exciting forms of di@@ d@@ ac@@ tic viol@@ in pe@@ da@@ go@@ gy .	我 感到 很 害怕 不是 为 我 自己 的 安全 担心 ， 而是 害怕 我会 失去 他 他 又 会 沉@@ 浸 到 他 的 某 一种 他 的 状态 中 而 我会 毁 了 他 和 小@@ 提@@ 琴 建立 起来 的 关系 如果 我 开始 讲 音@@ 阶 和@@ 琶@@ 音 和 其他 形式 的 精彩 的 说@@ 教@@ 式 的 小@@ 提@@ 琴 教@@ 学@@ 法
so , i just started playing .	于是 ， 我 开始 拉@@ 琴
and i played the first movement of the bee@@ tho@@ ven viol@@ in concer@@ to .	我 演奏 了 贝@@ 多@@ 芬 小@@ 提@@ 琴 协@@ 奏@@ 曲 的 第一 乐@@ 章
and as i played , i understood that there was a profound change oc@@ curr@@ ing in na@@ than@@ iel &apos;s eyes .	当 我 演奏 的 时候 我 知道 na@@ than@@ iel 的 眼睛 里 有 一种 奥@@ 妙 的 变化
it was as if he was in the gri@@ p of some invisible pharmac@@ eu@@ tical , a chemical reaction , for which my playing the music was its catal@@ y@@ st .	好@@ 象 他 抓住 了 什么 隐@@ 形 的 药 象@@ 是 经历 了 化学@@ 反应 ， 而 我 的 演奏 就是 催@@ 化@@ 剂
and na@@ than@@ iel &apos;s man@@ ic ra@@ ge was transformed into understanding , a quiet curiosity and gr@@ ace .	他 的 狂@@ 躁 愤怒 也 转@@ 化@@ 成 理解 安静 的 好奇 ， 和 优雅
and in a mirac@@ le , he li@@ fted his own viol@@ in and he started playing , by ear , certain s@@ ni@@ ppe@@ ts of viol@@ in concer@@ to@@ s which he then asked me to complete -- men@@ del@@ s@@ so@@ h@@ n , t@@ cha@@ i@@ ko@@ v@@ sky , si@@ beli@@ us .	神奇 的 是 ， 他 拿 起 了 他 的 小@@ 提@@ 琴 他 也 跟着 开始 演奏 小@@ 提@@ 琴 协@@ 奏@@ 曲 的 某些 片@@ 断 然后 他 又 要 我 来 完成 ， 门@@ 德@@ 尔@@ 松 柴@@ 可@@ 夫@@ 斯@@ 基 ， 西@@ 贝@@ 柳@@ 斯
and we started talking about music , from b@@ ach to bee@@ tho@@ ven and bra@@ h@@ ms , br@@ uc@@ k@@ ner , all the b &apos;s , from bar@@ t@@ ó@@ k , all the way up to e@@ sa@@ -@@ pe@@ k@@ ka sal@@ on@@ en .	于是 我们 开始 谈论 音乐 ： 从 巴@@ 赫 到 贝@@ 多@@ 芬 ， 布@@ 拉@@ 姆斯 布鲁@@ 克@@ 纳 ， 所有 名字 以 b 打@@ 头 的 人 从 巴@@ 托@@ 克 一直 到 艾@@ 沙 · 佩@@ 卡 · 萨 洛@@ 宁
and i understood that he not only had an en@@ cy@@ clo@@ pe@@ di@@ c knowledge of music , but he related to this music at a personal level .	我 了解 到 他 不@@ 但 是 一本 音乐 大@@ 百@@ 科@@ 全@@ 书 而且 他 能 将 这些 音乐 跟 他 个人 的 感受 联系 起来
he spoke about it with the kind of passion and understanding that i share with my colleagues in the los angeles phil@@ har@@ mon@@ ic .	他 讲 到 那些 东西 时 充满 了 激情 和 对 音乐 深刻 的 理解 ， 仿佛 是 我 跟 我 在 洛杉矶 交@@ 响@@ 乐团 的 同事 们 之间 交流 时 一样
and through playing music and talking about music , this man had transformed from the par@@ an@@ o@@ id , dist@@ ur@@ bed man that had just come from walking the streets of down@@ town los angeles to the char@@ ming , er@@ u@@ d@@ ite , brilliant , ju@@ il@@ li@@ ar@@ d-@@ trained musici@@ an .	通过 演奏 音乐 ， 谈论 音乐 这个 人 从 一个 偏@@ 执 ， 不安 的 刚才 还 在 洛杉矶 大街 上 晃@@ 悠 的 流@@ 浪@@ 汉 变成 了 一个 迷人 ， 博@@ 学 优秀 的 受@@ 过 朱@@ 丽@@ 亚 音乐@@ 学院 教育 的 音乐家
music is medicine . music changes us .	音乐 是 良@@ 药 。 音乐 改变 着 我们
and for na@@ than@@ iel , music is san@@ ity .	对 na@@ than@@ iel 来说 ， 音乐 是 帮助 他 开启 心@@ 智
because music allows him to take his thoughts and de@@ lu@@ sions and shape them through his imagination and his creativity , into reality .	因为 音乐 可以 帮 他 将 他 的 思维 妄@@ 想 ， 转换 成@@ 形 通过 他 的 想象力 和 创造力 变成 现实
and that is an es@@ cape from his tor@@ mented state .	而 正是 这个 帮助 他 从 煎@@ 熬 中 解@@ 脱 出来
and i understood that this was the very ess@@ ence of art .	而 我 知道 这 就是 艺术 的 真@@ 髓
this was the very reason why we made music , that we take something that exists within all of us at our very fundamental core , our emotions , and through our arti@@ stic l@@ ens , through our creativity , we &apos;re able to shape those emotions into reality .	这 正是 我们 创造 音乐 的 原因 我们 用 我们 每个 人 都 拥有 的 一种 内在 我们 的 最 根本 的 核心 我们 的 感情 通过 我们 的 艺术 的 镜头 通过 我们 的 创造力 ， 将 我们 的 情感 塑@@ 造成 现实
and the reality of that expression re@@ aches all of us and moves us , inspi@@ res and un@@ ites us .	而 这种 现实 的 表达 传递 给 我们 所有 的 人 感@@ 动 我们 ， 启@@ 迪 我们 ， 团@@ 结 我们
and for na@@ than@@ iel , music brought him back into a fold of friends .	而 对 na@@ than@@ iel 音乐 把 他 带 回到 一群 朋友 中
the re@@ de@@ mp@@ tive power of music brought him back into a family of musicians that understood him , that recognized his tal@@ ents and re@@ spe@@ cted him .	音乐 的 挽救 力 将 他 带 回到 音乐 的 大@@ 家庭 这里 人们 理解 他 承认 他 的 天赋 尊重 他
and i will always make music with na@@ than@@ iel , whether we &apos;re at wal@@ t dis@@ ney concer@@ t hall or on sk@@ id row , because he re@@ minds me why i became a musici@@ an .	而 我会 永远 为 他 创造 音乐 无论是 在 迪@@ 斯@@ 尼 的 音乐@@ 厅 或者 sk@@ id row 的 大街 上 ， 因为 他 提@@ 示 着 我 为什么 我要 做 音乐家
thank you .	谢谢
br@@ un@@ o gi@@ us@@ san@@ i : thank you . thanks .	br@@ un@@ o gi@@ us@@ san@@ i : 谢谢 ， 谢谢
robert gu@@ p@@ ta .	robert gu@@ p@@ ta .
robert gu@@ p@@ ta : i &apos;m going to play something that i sha@@ me@@ lessly sto@@ le from cel@@ li@@ sts .	robert gu@@ p@@ ta ： 现在 我 给 大家 演奏 一段 我 厚@@ 颜 从 大@@ 提@@ 琴@@ 手 那里 窃@@ 来 的 曲子
so , please for@@ give me .	所以 请@@ 原@@ 谅 我
so , i &apos;ve known a lot of fish in my life .	我 一生 中 接触 过 很多 鱼 。
i &apos;ve loved only two .	只有 两种 是 我 的 最 爱 。
that first one , it was more like a passionate aff@@ air .	第@@ 一种 ， 是 源于 激情 。
it was a beautiful fish : fla@@ v@@ or@@ ful , tex@@ tured , me@@ at@@ y , a be@@ st@@ sel@@ ler on the men@@ u .	它 是 一条 美丽 的 鱼 ， 美@@ 味 ， 纹@@ 理 细@@ 腻 ， 肉@@ 质 丰富 ， 是 菜@@ 单 上 最 受欢迎 的 鱼 。
what a fish .	多么 美@@ 的 鱼 啊 ！
even better , it was far@@ m@@ -@@ raised to the supposed highest standards of sustainability .	更好 的 是 ， 它 是 依@@ 照 最高 标准 养@@ 殖 的 ， 目的 是 保持 它 的 可@@ 持续性 的 。
so you could feel good about selling it .	而 卖 他 的 人 也 会 感到 心@@ 安@@ 理@@ 得 。
i was in a relationship with this beauty for several months .	我 曾经 沉@@ 醉@@ 于 这 美丽 的 关系 中 ， 时间 大概 延@@ 续 了 几个 月 。
one day , the head of the company called and asked if i &apos;d speak at an event about the farm &apos;s sustainability .	有 一天 ， 这个 公司 的 高@@ 层 打电话 给 我 邀请 我 参加 一个 活动 并 就 渔@@ 业 的 可@@ 持续性 发展 发@@ 表@@ 演@@ 说 。
&quot; absolutely , &quot; i said .	我 说 ， “ 当然 可以 ” 。
here was a company trying to solve what &apos;s become this un@@ imagin@@ able problem for us che@@ f@@ s : how do we keep fish on our men@@ us ?	这个 公司 正是 要 试图 解决 一个 对于 我们 厨@@ 师 来说 正在 变得 不可 想象 的 问题 。 “ 我们 如何 把 鱼类 留在 菜@@ 单 上 ？ ”
for the past 50 years , we &apos;ve been fishing the se@@ as like we clear@@ -@@ cut forests .	在 过去 的 50 年 中 ， 我们 从 各个 海洋 中 捕@@ 鱼 就 像是 砍@@ 伐 树木 。
it &apos;s hard to over@@ state the destruction .	绝@@ 不 是 夸@@ 大 它 的 破@@ 坏@@ 性 。
n@@ ine@@ ty percent of large fish , the ones we love -- the tun@@ as , the h@@ ali@@ bu@@ ts , the sal@@ mon@@ s , s@@ wor@@ d@@ fish -- they &apos;ve collap@@ sed .	90% 的 大型 鱼类 ， 那些 我们 喜爱 的 种类 ， 金枪鱼 ， 大 比@@ 目@@ 鱼 ， 三 鲑@@ 鱼 ， 剑@@ 鱼 ， 他们 都 要 灭绝 了 。
there &apos;s almost nothing left .	几乎 没有 多少 剩下 了 。
so , for better or for worse , a@@ qu@@ ac@@ ul@@ ture , fish far@@ ming , is going to be a part of our future .	所以 ， 不管 是 好 是 坏 ， 水@@ 产 养@@ 殖@@ 业 ， 养@@ 鱼@@ 业 ， 都 会 成为 我们 未来 的 一部分 。
a lot of arguments against it : fish far@@ ms pollu@@ te -- most of them do anyway -- and they &apos;re in@@ efficient . take tun@@ a , a major dra@@ w@@ back .	有 很多 针对 这个 行业 的 言@@ 论 。 其实 它们 大部分 都 是 关于 养@@ 鱼@@ 业 会 污@@ 染@@ 环境 ， 而且 效率 很 低 ， 比如说 金枪鱼 。 最大 的 弊@@ 病 就是 ，
it &apos;s got a feed conver@@ sion ra@@ ti@@ o of 15 to one .	养@@ 殖 金枪鱼 的 饲@@ 料 转@@ 换@@ 率 是 15 比 1 。
that means it takes fif@@ te@@ en pounds of wild fish to get you one pound of farm tun@@ a .	这个 意思 是 说 ， 每 生产 1 磅 金枪鱼 肉 要 耗@@ 费 15 磅 用 其他 野@@ 生 鱼类 做 的 饲@@ 料 。
not very sustainable .	这 可不是 很 具有 可 持续 发展@@ 性 。
it doesn &apos;t taste very good either .	而且 也 不 好@@ 吃 。
so here , finally , was a company trying to do it right .	最后 ， 这个 公司 想 做些 正确 事情 。
i wanted to support them .	我 也 想 支持 他们 。
the day before the event , i called the head of p@@ .@@ r@@ . for the company .	在 那@@ 次 活动 的 前@@ 一天 ， 我 联系 了 公司 的 公@@ 关 部门 头@@ 头 。
let &apos;s call him don .	就让 我们 暂@@ 且 称@@ 呼 他 为 “ 唐 阁@@ 下 ” 。
&quot; don , &quot; i said , &quot; just to get the facts straight , you guys are famous for far@@ ming so far out to sea , you don &apos;t pollu@@ te . &quot;	我 说 ： “ 唐 阁@@ 下 ， 据 我 说 知 ， 事实 是 这样 的 ， 你们 在 海洋 捕@@ 鱼@@ 业 十分 出@@ 名 ， 而且 你们 不会 产生 污染 。 ”
&quot; that &apos;s right , &quot; he said . &quot; we &apos;re so far out , the waste from our fish gets distributed , not concentr@@ ated . &quot;	他 回应 ： “ 你 说 的 对 。 我们 作业 的 地点 很 远 ， 我们 捕@@ 鱼 所 产生 的 污@@ 染@@ 物 都 被 稀@@ 释 掉 了 ， 不会 集中 残@@ 留 在 一个 地方 。 ”
and then he added , &quot; we &apos;re basically a world un@@ to ourselves .	然后 他 补@@ 充 到 ， “ 我们 算@@ 得 上 是 独@@ 树@@ 一@@ 帜 。
that feed conver@@ sion ra@@ ti@@ o ? 2.@@ 5 to one , &quot; he said .	饲@@ 料 转@@ 换@@ 率 ？ 2.@@ 5 比 1 ， ” 他 说 。
&quot; best in the business . &quot;	“ 行业 中 最好 的 。 ”
2.@@ 5 to one , great .	2.@@ 5 比 1 ， 很 好 。
&quot; 2.@@ 5 what ? what are you feeding ? &quot;	“ 什么 2.@@ 5 比 1 ？ 你们 在 喂 什么 ？ ”
&quot; sustainable proteins , &quot; he said .	他 回答 道 ： “ 可@@ 持续性 蛋白质 ” 。
&quot; great , &quot; i said . got off the phone .	我 说 ： “ 很 好 ” 。 然后 挂 了 电话 。
and that night , i was lying in bed , and i thought : what the hell is a sustainable protein ?	结果 那@@ 晚 ， 我 躺 在 床上 想 ： 可@@ 持续性 蛋白质 是 什么 鬼 东西 ？
so the next day , just before the event , i called don .	所以 第二天 ， 就 在 那个 活动 之前 ， 我 打电话 给 唐 阁@@ 下 。
i said , &quot; don , what are some examples of sustainable proteins ? &quot;	我 问@@ 道 ： ' 唐 阁@@ 下 ， 你 有没有 一些 可@@ 持续性 蛋白质 的 例子 ？ "
he said he didn &apos;t know . he would ask around .	他 说 他 不 知道 。 他会 去 问@@ 问 周围 的 人 。
well , i got on the phone with a few people in the company ; no one could give me a straight answer until finally , i got on the phone with the head bio@@ logist .	然后 ， 我 和 这个 公司 里 的 一些 人@@ 通 了 电话 。 但是 没有 人能 给 我 一个 明确 的 答案 。 直到 最后 ， 我@@ 通 上 了 电话 对方 是 生物学 专家 。
let &apos;s call him don too .	让 我 也 暂@@ 且 叫 他 “ 唐 阁@@ 下 ” 。
&quot; don , &quot; i said , &quot; what are some examples of sustainable proteins ? &quot;	我 说 ： “ 唐 阁@@ 下 ” “ 可以 举@@ 例@@ 说明 一下 可@@ 持续性 蛋白质 吗 ？ ”
well , he mentioned some al@@ ga@@ es and some fish me@@ als , and then he said chicken pe@@ l@@ lets .	恩 ， 他 提到 了 一些 藻@@ 类 还有 一些 鱼@@ 食 ， 然后 他 提到 鸡@@ 丸 。
i said , &quot; chicken pe@@ l@@ lets ? &quot;	我 问@@ 道 ： “ 鸡@@ 丸 ? ”
he said , &quot; yeah , f@@ ea@@ thers , skin , bone me@@ al , scra@@ ps , dri@@ ed and process@@ ed into feed . &quot;	他 说 ， “ 是 ， 羽@@ 毛 ， 鸡@@ 皮 ， 骨骼 ， 排@@ 泄@@ 物 ， 被 晒@@ 干 加@@ 工 后 添@@ 入 饲@@ 料 。 ”
i said , &quot; what percentage of your feed is chicken ? &quot;	我 说 ： “ 鸡 在 饲@@ 料 中 的 比例 是 多少 ？ ”
thinking , you know , two percent .	想 一下 ， 你 知道 ， 2% 。
&quot; well , it &apos;s about 30 percent , &quot; he said .	结果 他 说 ： “ 恩 ， 大概 占 3@@ 0% ， ”
i said , &quot; don , what &apos;s sustainable about feeding chicken to fish ? &quot;	我 说 ， “ 唐 阁@@ 下 ， 用@@ 鸡 喂@@ 鱼 ， 这@@ 算 什么 可 持续 发展@@ 性 ？ ”
there was a long pa@@ use on the line , and he said , &quot; there &apos;s just too much chicken in the world . &quot;	电话 的 那边 安静 了 很 长时间 ， 然后 他 对 我 说 ， “ 世界 上 就是 有@@ 太多 的 鸡 了 。 ”
i fell out of love with this fish .	于是 ， 我 不再 爱 这个 鱼 了 。
no , not because i &apos;m some self-@@ ri@@ gh@@ te@@ ous , goo@@ d@@ y-@@ two shoes fo@@ o@@ die .	不 ， 不是 因为 我 是 个 自@@ 以@@ 为@@ 是 ， 伪@@ 善 的 美@@ 食@@ 家 。
i actually am .	其实 我 是 这样 的 人 。
no , i actually fell out of love with this fish because , i sw@@ ear to god , after that conversation , the fish ta@@ sted like chicken .	不 ， 我 不再 爱 这个 鱼 了 ， 是因为 ， 我 向 上帝 发@@ 誓 ， 在 那@@ 次 对话 之后 ， 那个 鱼@@ 尝 起来 更 像 鸡 。
this second fish , it &apos;s a different kind of love story .	这 第二@@ 条 鱼 ， 它 则 是 另 一种 不同 的 爱@@ 情@@ 故事 。
it &apos;s the romantic kind , the kind where the more you get to know your fish , you love the fish .	是 很 浪@@ 漫 的 那种 ， 那种 你 越 多 了解 你 的 鱼 ， 你 就 越 爱 它 。
i first ate it at a restaurant in southern sp@@ ain .	我 第一次 在 一个 饭@@ 店 中 吃 到 这种 鱼 ， 位置 在 西班牙 南部 。
a journalist friend had been talking about this fish for a long time .	很久@@ 以前 一个 记者 朋友 和 我 说 过 这里 。
she kind of set us up .	她 可以 说 是 个 媒@@ 人 。
it came to the table a bright , almost sh@@ im@@ mer@@ ing , white color .	那条 鱼 在 桌子 上 很 亮 ， 有着 光@@ 晕 ， 白色 的 那种 。
the che@@ f had over@@ coo@@ ked it .	厨@@ 师 烹饪 它 的 时间 过@@ 长 了 。
like twice over .	好像 是 烹饪 了 两次 。
amaz@@ ingly , it was still deli@@ ci@@ ous .	但是 太 神奇 了 ， 它 还是 很 好@@ 吃 。
who can make a fish taste good after it &apos;s been over@@ coo@@ ked ?	谁 可以 做出 这样 好@@ 吃 的 鱼 而且 还是 在 烹饪 时间 过@@ 长 的 情况 下 ？
i can &apos;t , but this guy can .	我 不能 ， 但是 这个 人 可以 。
let &apos;s call him mi@@ gu@@ el -- actually his name is mi@@ gu@@ el .	让 我们 叫 他 米@@ 格@@ 尔 。 其实 他 的 名字 就是 米@@ 格@@ 尔 。
and no , he didn &apos;t cook the fish , and he &apos;s not a che@@ f , at least in the way that you and i understand it .	但是 ， 他 没有 烹@@ 调 那条 鱼 ， 他 也 不是 个 厨@@ 师 。 至少 在 你 我 理解 的 方式 之内 他 不是 。
he &apos;s a bio@@ logist at ve@@ ta la pal@@ ma .	他 是 一个 生物学家 在 薇 塔 拉@@ 帕@@ 尔@@ 马 。
it &apos;s a fish farm in the sou@@ th@@ western corner of sp@@ ain .	他 是 个 位于 西班牙 西@@ 南@@ 角 的 养@@ 鱼@@ 场 。
it &apos;s at the ti@@ p of the gu@@ ad@@ al@@ qui@@ vi@@ r river .	他 就 在 高 达@@ 尔 克@@ 维@@ 尔 河 的 尖@@ 部 。
until the 198@@ 0s , the farm was in the hands of the ar@@ gent@@ ini@@ ans .	直到 上@@ 个@@ 世纪 80 年代 ， 这个 渔@@ 场 是 阿@@ 根@@ 廷 人 管@@ 辖 的 。
they raised be@@ ef cat@@ tle on what was essentially we@@ t@@ lands .	他们 在 这里 养@@ 牛 那个 时候 这里 基本上 是 湿@@ 地 。
they did it by dra@@ ining the land .	当时 他们 把 水 抽@@ 走 。
they built this intri@@ cate series of can@@ als , and they pu@@ shed water off the land and out into the river .	然后 建造 一系列 复杂 的 运@@ 河 ， 他们 接着 把 这里 的 水 排@@ 入 河@@ 流 。
well , they couldn &apos;t make it work , not econom@@ ically .	但是 ， 他们 没有 成功 ， 我 是 指 经济 方面 。